ID,Флаг дозвона,Флаг продажи,Расходы,PV,NPV
0,1,1,507,1478,971
1,0,0,27,0,-27
2,0,0,29,0,-29
3,1,0,27,0,-27
4,1,0,41,0,-41
5,1,0,48,0,-48
6,1,0,4,0,-4
7,1,1,640,1228,588
8,1,0,38,0,-38
9,1,0,9,0,-9
10,0,0,117,0,-117
11,1,1,230,1407,1177
12,0,0,55,0,-55
13,0,0,72,0,-72
14,1,0,113,0,-113
15,0,0,122,0,-122
16,0,0,94,0,-94
17,1,0,19,0,-19
18,1,1,116,1390,1274
19,1,0,21,0,-21
20,0,0,129,0,-129
21,1,1,1179,1438,259
22,1,1,1338,1386,48
23,1,1,1999,1528,-471
24,0,0,35,0,-35
25,1,0,119,0,-119
26,1,1,220,1300,1080
27,0,0,2,0,-2
28,1,1,404,1221,817
29,0,0,67,0,-67
30,0,0,42,0,-42
31,0,0,80,0,-80
32,1,1,1099,1255,156
33,1,1,383,1225,842
34,0,0,25,0,-25
35,1,1,645,1265,620
36,1,0,52,0,-52
37,1,0,4,0,-4
38,1,1,172,3028,2856
39,0,0,16,0,-16
40,1,1,249,1995,1746
41,0,0,9,0,-9
42,0,0,1,0,-1
43,1,1,262,1293,1031
44,1,1,228,1213,985
45,1,1,1625,2436,811
46,1,0,4,0,-4
47,1,1,246,3314,3068
48,0,0,214,0,-214
49,0,0,84,0,-84
50,1,0,6,0,-6
51,1,1,356,1757,1401
52,0,0,198,0,-198
53,0,0,116,0,-116
54,1,0,11,0,-11
55,0,0,73,0,-73
56,0,0,21,0,-21
57,0,0,31,0,-31
58,1,1,221,1229,1008
59,1,0,28,0,-28
60,0,0,44,0,-44
61,1,0,4,0,-4
62,0,0,1,0,-1
63,1,1,801,1533,732
64,0,0,48,0,-48
65,0,0,57,0,-57
66,1,1,1013,2138,1125
67,1,0,30,0,-30
68,1,0,79,0,-79
69,0,0,10,0,-10
70,0,0,112,0,-112
71,1,1,798,1305,507
72,0,0,46,0,-46
73,0,0,56,0,-56
74,0,0,28,0,-28
75,0,0,49,0,-49
76,1,0,39,0,-39
77,0,0,83,0,-83
78,1,0,84,0,-84
79,1,1,519,1563,1044
80,0,0,27,0,-27
81,0,0,158,0,-158
82,1,1,529,1370,841
83,1,1,545,1212,667
84,1,0,71,0,-71
85,0,0,9,0,-9
86,1,1,138,1357,1219
87,0,0,32,0,-32
88,1,1,482,1308,826
89,0,0,30,0,-30
90,0,0,129,0,-129
91,0,0,9,0,-9
92,1,0,15,0,-15
93,1,0,44,0,-44
94,1,0,122,0,-122
95,1,1,1907,2171,264
96,1,1,287,2286,1999
97,0,0,6,0,-6
98,0,0,35,0,-35
99,0,0,99,0,-99
100,1,0,1,0,-1
101,0,0,16,0,-16
102,1,0,69,0,-69
103,1,1,147,1791,1644
104,1,0,187,0,-187
105,1,1,1154,1253,99
106,1,1,775,1502,727
107,0,0,59,0,-59
108,1,1,483,1572,1089
109,1,1,460,1311,851
110,1,1,90,1587,1497
111,1,0,55,0,-55
112,1,1,77,1571,1494
113,1,0,46,0,-46
114,0,0,147,0,-147
115,0,0,10,0,-10
116,0,0,61,0,-61
117,0,0,174,0,-174
118,0,0,76,0,-76
119,0,0,56,0,-56
120,0,0,17,0,-17
121,1,1,135,1417,1282
122,0,0,92,0,-92
123,1,0,75,0,-75
124,0,0,20,0,-20
125,0,0,25,0,-25
126,1,0,8,0,-8
127,1,0,32,0,-32
128,1,1,658,1407,749
129,1,1,318,1752,1434
130,1,0,194,0,-194
131,1,0,3,0,-3
132,0,0,57,0,-57
133,0,0,25,0,-25
134,1,1,195,1333,1138
135,1,0,52,0,-52
136,1,1,46,1414,1368
137,1,1,258,3124,2866
138,1,1,2631,1812,-819
139,0,0,102,0,-102
140,1,1,628,1322,694
141,0,0,78,0,-78
142,0,0,1,0,-1
143,0,0,81,0,-81
144,0,0,5,0,-5
145,1,1,2082,1344,-738
146,0,0,6,0,-6
147,1,0,48,0,-48
148,0,0,2,0,-2
149,0,0,130,0,-130
150,1,0,89,0,-89
151,1,1,550,1391,841
152,0,0,47,0,-47
153,0,0,32,0,-32
154,0,0,10,0,-10
155,0,0,76,0,-76
156,1,1,1000,1237,237
157,1,0,135,0,-135
158,1,1,201,1343,1142
159,0,0,0,0,0
160,1,0,58,0,-58
161,1,0,1,0,-1
162,0,0,14,0,-14
163,0,0,149,0,-149
164,0,0,97,0,-97
165,0,0,49,0,-49
166,1,0,2,0,-2
167,1,1,193,1299,1106
168,0,0,184,0,-184
169,0,0,60,0,-60
170,0,0,73,0,-73
171,1,1,974,2426,1452
172,0,0,28,0,-28
173,0,0,65,0,-65
174,1,1,228,1212,984
175,1,0,6,0,-6
176,0,0,43,0,-43
177,1,0,34,0,-34
178,0,0,31,0,-31
179,1,0,10,0,-10
180,1,1,305,1636,1331
181,1,1,205,1257,1052
182,1,0,6,0,-6
183,0,0,8,0,-8
184,1,0,3,0,-3
185,1,1,458,1984,1526
186,1,0,0,0,0
187,0,0,13,0,-13
188,1,1,101,1812,1711
189,1,1,230,1283,1053
190,0,0,46,0,-46
191,1,1,365,1294,929
192,1,0,75,0,-75
193,1,0,16,0,-16
194,0,0,6,0,-6
195,1,0,66,0,-66
196,1,0,161,0,-161
197,1,0,109,0,-109
198,0,0,6,0,-6
199,1,1,493,2007,1514
200,1,0,7,0,-7
201,0,0,30,0,-30
202,0,0,140,0,-140
203,1,0,67,0,-67
204,1,1,143,1234,1091
205,1,0,24,0,-24
206,1,1,716,1234,518
207,1,1,739,2065,1326
208,0,0,10,0,-10
209,1,1,278,1499,1221
210,1,0,203,0,-203
211,0,0,5,0,-5
212,1,1,1159,1230,71
213,1,1,1649,1587,-62
214,1,0,6,0,-6
215,1,1,30,1940,1910
216,0,0,9,0,-9
217,1,0,88,0,-88
218,0,0,5,0,-5
219,1,1,632,1541,909
220,0,0,29,0,-29
221,1,1,954,2105,1151
222,1,0,22,0,-22
223,1,0,91,0,-91
224,0,0,87,0,-87
225,1,0,81,0,-81
226,1,0,18,0,-18
227,1,1,155,2035,1880
228,1,1,1050,1704,654
229,0,0,96,0,-96
230,1,1,221,1713,1492
231,1,0,16,0,-16
232,0,0,16,0,-16
233,1,1,1535,1554,19
234,0,0,47,0,-47
235,1,1,644,1533,889
236,1,0,39,0,-39
237,1,0,30,0,-30
238,1,1,192,1336,1144
239,1,0,58,0,-58
240,1,0,80,0,-80
241,0,0,1,0,-1
242,1,1,197,1240,1043
243,0,0,113,0,-113
244,1,1,177,1202,1025
245,1,1,403,1271,868
246,0,0,25,0,-25
247,1,1,956,1415,459
248,1,0,0,0,0
249,1,0,14,0,-14
250,1,1,1174,1372,198
251,1,0,39,0,-39
252,1,0,3,0,-3
253,1,1,569,1778,1209
254,0,0,24,0,-24
255,0,0,213,0,-213
256,0,0,15,0,-15
257,0,0,59,0,-59
258,1,0,1,0,-1
259,1,1,747,1411,664
260,0,0,64,0,-64
261,0,0,53,0,-53
262,0,0,2,0,-2
263,0,0,65,0,-65
264,0,0,119,0,-119
265,0,0,3,0,-3
266,1,1,1040,1874,834
267,0,0,15,0,-15
268,1,1,169,1452,1283
269,1,0,45,0,-45
270,1,0,142,0,-142
271,1,0,124,0,-124
272,1,1,1344,1356,12
273,0,0,26,0,-26
274,1,1,764,1774,1010
275,1,1,533,1587,1054
276,1,0,101,0,-101
277,1,0,70,0,-70
278,0,0,33,0,-33
279,0,0,123,0,-123
280,1,0,102,0,-102
281,0,0,91,0,-91
282,1,1,185,1636,1451
283,1,1,117,1253,1136
284,0,0,0,0,0
285,1,0,18,0,-18
286,1,1,465,1330,865
287,1,0,47,0,-47
288,1,1,288,1392,1104
289,1,0,12,0,-12
290,0,0,191,0,-191
291,1,1,108,1650,1542
292,1,0,67,0,-67
293,0,0,4,0,-4
294,1,1,2134,1587,-547
295,0,0,44,0,-44
296,1,1,316,1627,1311
297,1,1,148,1234,1086
298,1,0,20,0,-20
299,1,1,158,1554,1396
300,0,0,35,0,-35
301,0,0,22,0,-22
302,1,1,135,1237,1102
303,1,0,3,0,-3
304,0,0,112,0,-112
305,1,0,19,0,-19
306,1,1,532,1750,1218
307,0,0,28,0,-28
308,0,0,23,0,-23
309,1,1,463,1643,1180
310,0,0,83,0,-83
311,1,1,86,2552,2466
312,1,0,117,0,-117
313,0,0,345,0,-345
314,1,0,44,0,-44
315,1,1,254,1625,1371
316,1,1,222,1952,1730
317,1,0,25,0,-25
318,0,0,36,0,-36
319,0,0,8,0,-8
320,1,0,52,0,-52
321,1,0,7,0,-7
322,0,0,62,0,-62
323,0,0,40,0,-40
324,1,1,379,1539,1160
325,1,0,42,0,-42
326,1,0,2,0,-2
327,1,0,34,0,-34
328,0,0,4,0,-4
329,1,0,60,0,-60
330,1,1,35,1360,1325
331,1,0,29,0,-29
332,1,1,84,1226,1142
333,1,1,1373,1237,-136
334,0,0,57,0,-57
335,0,0,70,0,-70
336,1,0,138,0,-138
337,1,1,456,1556,1100
338,0,0,10,0,-10
339,1,0,51,0,-51
340,1,1,264,1328,1064
341,0,0,5,0,-5
342,0,0,3,0,-3
343,0,0,48,0,-48
344,0,0,81,0,-81
345,1,1,951,1414,463
346,1,1,436,1264,828
347,1,1,394,1306,912
348,1,1,883,1295,412
349,1,0,47,0,-47
350,1,0,10,0,-10
351,0,0,21,0,-21
352,0,0,23,0,-23
353,0,0,56,0,-56
354,1,0,14,0,-14
355,1,1,775,1741,966
356,1,0,58,0,-58
357,1,1,181,2103,1922
358,0,0,23,0,-23
359,1,0,26,0,-26
360,0,0,26,0,-26
361,1,1,70,1203,1133
362,1,1,400,2658,2258
363,1,0,32,0,-32
364,1,0,109,0,-109
365,0,0,10,0,-10
366,1,0,45,0,-45
367,1,0,20,0,-20
368,1,0,55,0,-55
369,1,1,74,1568,1494
370,1,0,26,0,-26
371,1,0,11,0,-11
372,0,0,32,0,-32
373,1,1,309,2005,1696
374,0,0,12,0,-12
375,0,0,51,0,-51
376,1,1,107,1210,1103
377,1,1,87,1540,1453
378,0,0,40,0,-40
379,0,0,293,0,-293
380,0,0,7,0,-7
381,0,0,78,0,-78
382,0,0,8,0,-8
383,1,0,65,0,-65
384,0,0,48,0,-48
385,1,0,74,0,-74
386,0,0,17,0,-17
387,1,0,32,0,-32
388,1,0,20,0,-20
389,0,0,8,0,-8
390,0,0,57,0,-57
391,0,0,0,0,0
392,0,0,61,0,-61
393,0,0,11,0,-11
394,0,0,101,0,-101
395,1,1,8,1519,1511
396,1,1,461,1253,792
397,0,0,47,0,-47
398,1,1,277,1631,1354
399,0,0,11,0,-11
400,1,0,48,0,-48
401,1,0,88,0,-88
402,0,0,33,0,-33
403,1,0,20,0,-20
404,1,1,524,1250,726
405,1,0,20,0,-20
406,1,1,2708,1709,-999
407,0,0,175,0,-175
408,1,0,43,0,-43
409,1,0,59,0,-59
410,1,0,16,0,-16
411,0,0,26,0,-26
412,0,0,48,0,-48
413,1,1,59,1204,1145
414,0,0,29,0,-29
415,0,0,1,0,-1
416,0,0,197,0,-197
417,1,1,351,1200,849
418,1,1,139,1696,1557
419,1,0,46,0,-46
420,0,0,79,0,-79
421,0,0,59,0,-59
422,0,0,7,0,-7
423,0,0,7,0,-7
424,0,0,89,0,-89
425,1,0,31,0,-31
426,1,0,125,0,-125
427,1,0,6,0,-6
428,0,0,78,0,-78
429,1,1,219,1568,1349
430,1,1,1242,2400,1158
431,1,0,52,0,-52
432,1,1,157,1333,1176
433,0,0,23,0,-23
434,1,0,34,0,-34
435,1,1,589,1405,816
436,1,1,293,1214,921
437,1,0,61,0,-61
438,1,1,377,1429,1052
439,1,0,28,0,-28
440,1,1,272,1312,1040
441,1,0,27,0,-27
442,1,0,10,0,-10
443,1,0,28,0,-28
444,1,0,5,0,-5
445,1,0,0,0,0
446,0,0,6,0,-6
447,1,1,208,1434,1226
448,0,0,10,0,-10
449,0,0,8,0,-8
450,0,0,48,0,-48
451,0,0,33,0,-33
452,1,1,363,1321,958
453,0,0,5,0,-5
454,1,0,2,0,-2
455,0,0,52,0,-52
456,0,0,76,0,-76
457,0,0,33,0,-33
458,0,0,3,0,-3
459,1,1,1255,1454,199
460,1,1,1463,2366,903
461,1,1,80,1460,1380
462,1,0,21,0,-21
463,1,1,492,1213,721
464,0,0,20,0,-20
465,1,0,5,0,-5
466,1,1,341,1902,1561
467,1,0,10,0,-10
468,1,0,29,0,-29
469,1,0,4,0,-4
470,1,1,684,1497,813
471,0,0,43,0,-43
472,0,0,104,0,-104
473,1,1,167,2120,1953
474,0,0,7,0,-7
475,1,0,67,0,-67
476,1,1,226,1624,1398
477,0,0,75,0,-75
478,1,1,355,1484,1129
479,1,0,40,0,-40
480,1,0,6,0,-6
481,1,1,62,2696,2634
482,0,0,4,0,-4
483,1,0,59,0,-59
484,0,0,9,0,-9
485,0,0,81,0,-81
486,0,0,22,0,-22
487,1,0,23,0,-23
488,0,0,123,0,-123
489,0,0,5,0,-5
490,1,0,102,0,-102
491,1,1,982,1686,704
492,1,0,0,0,0
493,1,0,56,0,-56
494,0,0,169,0,-169
495,1,0,0,0,0
496,1,1,1661,1660,-1
497,1,1,542,2102,1560
498,1,1,306,2561,2255
499,0,0,68,0,-68
500,1,0,114,0,-114
501,0,0,14,0,-14
502,0,0,14,0,-14
503,1,1,302,1561,1259
504,0,0,54,0,-54
505,0,0,51,0,-51
506,0,0,37,0,-37
507,1,1,528,1785,1257
508,1,1,224,1615,1391
509,1,1,593,1754,1161
510,1,1,350,2205,1855
511,1,0,43,0,-43
512,0,0,125,0,-125
513,1,0,93,0,-93
514,1,1,202,1346,1144
515,0,0,94,0,-94
516,1,0,11,0,-11
517,1,0,12,0,-12
518,1,1,342,2830,2488
519,1,1,763,1207,444
520,0,0,12,0,-12
521,0,0,5,0,-5
522,1,0,0,0,0
523,0,0,38,0,-38
524,0,0,9,0,-9
525,1,1,360,1274,914
526,0,0,35,0,-35
527,0,0,16,0,-16
528,0,0,50,0,-50
529,1,0,25,0,-25
530,1,1,197,1277,1080
531,0,0,76,0,-76
532,1,0,28,0,-28
533,0,0,9,0,-9
534,1,0,4,0,-4
535,1,1,543,2663,2120
536,0,0,17,0,-17
537,0,0,118,0,-118
538,1,0,21,0,-21
539,1,0,106,0,-106
540,0,0,38,0,-38
541,1,1,977,1651,674
542,0,0,46,0,-46
543,1,0,113,0,-113
544,1,0,119,0,-119
545,0,0,136,0,-136
546,0,0,89,0,-89
547,1,0,15,0,-15
548,1,1,724,1382,658
549,1,0,40,0,-40
550,1,1,307,2034,1727
551,1,0,22,0,-22
552,1,0,172,0,-172
553,1,1,101,1674,1573
554,1,1,332,1492,1160
555,1,1,449,1414,965
556,0,0,97,0,-97
557,0,0,16,0,-16
558,1,0,16,0,-16
559,1,0,7,0,-7
560,1,1,345,1290,945
561,0,0,35,0,-35
562,1,0,19,0,-19
563,1,1,394,1328,934
564,0,0,67,0,-67
565,0,0,6,0,-6
566,1,0,112,0,-112
567,1,0,14,0,-14
568,0,0,38,0,-38
569,1,1,976,1212,236
570,0,0,116,0,-116
571,1,0,3,0,-3
572,0,0,31,0,-31
573,1,1,1747,1553,-194
574,0,0,9,0,-9
575,1,1,1010,1418,408
576,1,1,999,1237,238
577,1,1,318,1354,1036
578,0,0,42,0,-42
579,1,1,1144,1725,581
580,1,1,748,1577,829
581,1,1,27,1277,1250
582,1,1,69,2031,1962
583,1,1,403,1384,981
584,0,0,24,0,-24
585,1,1,689,1259,570
586,1,1,382,1333,951
587,1,0,43,0,-43
588,0,0,38,0,-38
589,0,0,1,0,-1
590,1,1,232,1877,1645
591,1,1,178,1266,1088
592,0,0,15,0,-15
593,0,0,22,0,-22
594,0,0,28,0,-28
595,0,0,3,0,-3
596,0,0,139,0,-139
597,1,0,1,0,-1
598,1,0,37,0,-37
599,0,0,64,0,-64
600,1,0,30,0,-30
601,0,0,5,0,-5
602,0,0,23,0,-23
603,0,0,35,0,-35
604,1,1,521,1231,710
605,0,0,47,0,-47
606,1,0,63,0,-63
607,1,1,720,1208,488
608,1,0,16,0,-16
609,1,1,904,2375,1471
610,1,1,307,1644,1337
611,1,1,572,1414,842
612,0,0,13,0,-13
613,1,1,353,1432,1079
614,1,1,384,2707,2323
615,1,1,64,1823,1759
616,1,1,976,1367,391
617,1,1,244,1589,1345
618,1,1,83,1542,1459
619,1,1,362,1345,983
620,0,0,8,0,-8
621,1,0,43,0,-43
622,1,1,1075,1853,778
623,1,0,32,0,-32
624,1,1,998,1465,467
625,1,0,37,0,-37
626,1,0,26,0,-26
627,1,0,12,0,-12
628,1,0,34,0,-34
629,0,0,146,0,-146
630,1,0,52,0,-52
631,0,0,27,0,-27
632,0,0,90,0,-90
633,1,0,158,0,-158
634,0,0,192,0,-192
635,0,0,25,0,-25
636,0,0,28,0,-28
637,0,0,2,0,-2
638,1,0,28,0,-28
639,1,0,117,0,-117
640,1,1,148,1265,1117
641,1,0,132,0,-132
642,0,0,96,0,-96
643,0,0,31,0,-31
644,1,1,299,2202,1903
645,1,1,452,1281,829
646,0,0,27,0,-27
647,0,0,195,0,-195
648,1,0,61,0,-61
649,1,0,9,0,-9
650,0,0,107,0,-107
651,0,0,75,0,-75
652,0,0,54,0,-54
653,1,0,17,0,-17
654,0,0,35,0,-35
655,1,1,480,1292,812
656,1,0,158,0,-158
657,1,1,498,1210,712
658,1,0,87,0,-87
659,0,0,42,0,-42
660,0,0,35,0,-35
661,0,0,5,0,-5
662,0,0,25,0,-25
663,0,0,78,0,-78
664,1,0,6,0,-6
665,0,0,4,0,-4
666,0,0,9,0,-9
667,1,0,132,0,-132
668,1,1,255,1593,1338
669,1,1,174,1561,1387
670,1,1,203,3135,2932
671,0,0,3,0,-3
672,0,0,101,0,-101
673,1,0,45,0,-45
674,1,0,27,0,-27
675,1,1,183,1330,1147
676,1,0,13,0,-13
677,0,0,130,0,-130
678,0,0,25,0,-25
679,0,0,20,0,-20
680,1,1,642,1495,853
681,1,1,582,1618,1036
682,0,0,8,0,-8
683,1,0,1,0,-1
684,1,1,107,1309,1202
685,0,0,12,0,-12
686,0,0,165,0,-165
687,0,0,10,0,-10
688,0,0,9,0,-9
689,1,0,285,0,-285
690,1,1,116,6240,6124
691,1,1,383,1563,1180
692,1,0,14,0,-14
693,1,1,1400,1319,-81
694,1,0,0,0,0
695,0,0,131,0,-131
696,0,0,144,0,-144
697,0,0,87,0,-87
698,1,0,9,0,-9
699,0,0,6,0,-6
700,1,1,255,1404,1149
701,1,1,749,1458,709
702,0,0,23,0,-23
703,0,0,60,0,-60
704,0,0,1,0,-1
705,1,0,43,0,-43
706,1,1,99,1313,1214
707,0,0,40,0,-40
708,1,0,9,0,-9
709,0,0,58,0,-58
710,0,0,61,0,-61
711,1,1,298,1227,929
712,1,1,626,1883,1257
713,0,0,104,0,-104
714,1,1,324,1226,902
715,0,0,179,0,-179
716,0,0,24,0,-24
717,1,0,0,0,0
718,1,1,270,1223,953
719,0,0,18,0,-18
720,1,1,411,2418,2007
721,1,1,463,1225,762
722,1,0,134,0,-134
723,1,0,43,0,-43
724,0,0,65,0,-65
725,1,1,109,1256,1147
726,0,0,16,0,-16
727,0,0,125,0,-125
728,1,1,231,1658,1427
729,0,0,22,0,-22
730,1,0,21,0,-21
731,1,1,174,1440,1266
732,1,0,5,0,-5
733,0,0,118,0,-118
734,0,0,64,0,-64
735,1,1,131,1300,1169
736,1,0,79,0,-79
737,1,1,128,1673,1545
738,0,0,17,0,-17
739,1,0,5,0,-5
740,0,0,22,0,-22
741,1,0,1,0,-1
742,0,0,85,0,-85
743,1,1,268,1351,1083
744,0,0,0,0,0
745,1,0,43,0,-43
746,1,0,87,0,-87
747,1,1,267,1272,1005
748,1,0,28,0,-28
749,0,0,15,0,-15
750,1,1,1515,1521,6
751,1,1,243,1230,987
752,0,0,4,0,-4
753,0,0,70,0,-70
754,1,1,148,1496,1348
755,1,0,17,0,-17
756,0,0,26,0,-26
757,0,0,12,0,-12
758,1,1,536,1700,1164
759,1,0,27,0,-27
760,0,0,14,0,-14
761,0,0,21,0,-21
762,0,0,263,0,-263
763,1,0,56,0,-56
764,0,0,82,0,-82
765,0,0,31,0,-31
766,0,0,50,0,-50
767,0,0,26,0,-26
768,1,1,773,1649,876
769,1,1,1025,1200,175
770,1,0,12,0,-12
771,1,1,364,1514,1150
772,1,0,43,0,-43
773,0,0,40,0,-40
774,1,0,82,0,-82
775,0,0,7,0,-7
776,0,0,20,0,-20
777,1,1,470,1341,871
778,0,0,71,0,-71
779,1,1,1518,1636,118
780,1,0,1,0,-1
781,0,0,61,0,-61
782,1,0,42,0,-42
783,0,0,9,0,-9
784,0,0,55,0,-55
785,1,0,172,0,-172
786,1,0,96,0,-96
787,1,1,265,2050,1785
788,1,0,4,0,-4
789,1,1,875,2312,1437
790,1,0,30,0,-30
791,0,0,76,0,-76
792,1,0,38,0,-38
793,0,0,23,0,-23
794,1,1,417,1214,797
795,1,1,1067,1585,518
796,1,0,29,0,-29
797,1,1,299,1440,1141
798,1,0,4,0,-4
799,1,1,376,1693,1317
800,1,0,63,0,-63
801,0,0,0,0,0
802,0,0,55,0,-55
803,0,0,0,0,0
804,0,0,49,0,-49
805,1,1,57,1469,1412
806,1,1,342,1229,887
807,0,0,154,0,-154
808,0,0,60,0,-60
809,1,0,18,0,-18
810,1,0,1,0,-1
811,0,0,80,0,-80
812,1,0,5,0,-5
813,1,0,63,0,-63
814,0,0,4,0,-4
815,1,0,6,0,-6
816,1,0,27,0,-27
817,1,0,6,0,-6
818,1,1,1258,2381,1123
819,0,0,80,0,-80
820,0,0,9,0,-9
821,0,0,70,0,-70
822,1,1,230,1799,1569
823,1,1,948,1261,313
824,0,0,37,0,-37
825,0,0,15,0,-15
826,1,1,1595,1648,53
827,0,0,10,0,-10
828,0,0,23,0,-23
829,1,0,34,0,-34
830,1,0,54,0,-54
831,0,0,104,0,-104
832,0,0,4,0,-4
833,1,1,658,1276,618
834,1,1,1797,1462,-335
835,0,0,40,0,-40
836,1,0,3,0,-3
837,0,0,46,0,-46
838,1,1,1153,1525,372
839,0,0,32,0,-32
840,0,0,20,0,-20
841,1,1,522,1283,761
842,1,0,14,0,-14
843,0,0,19,0,-19
844,1,1,733,1505,772
845,1,1,278,1597,1319
846,0,0,12,0,-12
847,0,0,10,0,-10
848,1,1,230,2510,2280
849,0,0,96,0,-96
850,1,1,69,1273,1204
851,1,0,9,0,-9
852,1,0,46,0,-46
853,0,0,64,0,-64
854,1,1,569,1365,796
855,1,1,437,1698,1261
856,0,0,124,0,-124
857,0,0,21,0,-21
858,1,0,63,0,-63
859,1,0,33,0,-33
860,0,0,107,0,-107
861,1,1,432,1985,1553
862,1,1,230,2715,2485
863,1,0,21,0,-21
864,0,0,23,0,-23
865,0,0,29,0,-29
866,0,0,3,0,-3
867,1,1,1162,1224,62
868,1,0,298,0,-298
869,0,0,22,0,-22
870,0,0,14,0,-14
871,1,0,142,0,-142
872,0,0,87,0,-87
873,1,1,489,1391,902
874,1,1,910,1421,511
875,0,0,33,0,-33
876,0,0,7,0,-7
877,1,0,118,0,-118
878,0,0,12,0,-12
879,0,0,106,0,-106
880,0,0,14,0,-14
881,1,0,95,0,-95
882,1,0,20,0,-20
883,1,1,455,1367,912
884,0,0,29,0,-29
885,0,0,11,0,-11
886,0,0,1,0,-1
887,1,0,10,0,-10
888,1,1,238,1209,971
889,1,0,5,0,-5
890,1,0,68,0,-68
891,1,0,12,0,-12
892,0,0,37,0,-37
893,0,0,10,0,-10
894,1,0,217,0,-217
895,1,0,48,0,-48
896,1,0,54,0,-54
897,1,1,51,2426,2375
898,0,0,4,0,-4
899,0,0,44,0,-44
900,1,1,656,1593,937
901,1,1,125,3470,3345
902,1,1,430,1238,808
903,0,0,51,0,-51
904,1,1,445,1729,1284
905,1,1,117,1590,1473
906,1,0,62,0,-62
907,1,1,298,1292,994
908,1,0,14,0,-14
909,1,0,48,0,-48
910,1,1,408,1277,869
911,0,0,77,0,-77
912,1,1,46,1683,1637
913,0,0,19,0,-19
914,1,0,48,0,-48
915,0,0,35,0,-35
916,1,1,881,1245,364
917,1,1,725,2394,1669
918,1,0,95,0,-95
919,1,0,18,0,-18
920,0,0,84,0,-84
921,1,1,615,2024,1409
922,1,0,153,0,-153
923,0,0,37,0,-37
924,1,0,65,0,-65
925,0,0,9,0,-9
926,1,1,1280,1213,-67
927,1,0,227,0,-227
928,1,0,15,0,-15
929,1,0,75,0,-75
930,0,0,40,0,-40
931,1,1,200,1260,1060
932,1,1,1289,1319,30
933,1,1,669,1327,658
934,0,0,81,0,-81
935,1,0,37,0,-37
936,1,1,921,1304,383
937,1,0,52,0,-52
938,1,1,120,1639,1519
939,1,0,18,0,-18
940,1,0,47,0,-47
941,1,0,30,0,-30
942,1,1,413,1321,908
943,0,0,91,0,-91
944,1,1,351,1653,1302
945,0,0,0,0,0
946,1,1,895,1531,636
947,1,0,17,0,-17
948,1,0,0,0,0
949,0,0,8,0,-8
950,0,0,24,0,-24
951,1,0,155,0,-155
952,1,0,45,0,-45
953,1,0,7,0,-7
954,1,0,39,0,-39
955,1,0,4,0,-4
956,1,1,726,1312,586
957,0,0,34,0,-34
958,0,0,2,0,-2
959,0,0,52,0,-52
960,1,0,6,0,-6
961,0,0,21,0,-21
962,0,0,77,0,-77
963,0,0,78,0,-78
964,1,0,82,0,-82
965,0,0,1,0,-1
966,1,0,46,0,-46
967,1,0,37,0,-37
968,0,0,75,0,-75
969,1,1,105,2649,2544
970,0,0,7,0,-7
971,1,1,353,1378,1025
972,1,1,191,1502,1311
973,1,1,1475,1266,-209
974,1,0,31,0,-31
975,1,1,170,1327,1157
976,1,1,292,1982,1690
977,1,0,19,0,-19
978,1,0,15,0,-15
979,1,0,33,0,-33
980,1,1,1542,1316,-226
981,0,0,17,0,-17
982,0,0,37,0,-37
983,1,0,35,0,-35
984,0,0,46,0,-46
985,0,0,41,0,-41
986,1,1,404,1636,1232
987,0,0,30,0,-30
988,0,0,65,0,-65
989,1,1,963,2337,1374
990,1,1,1513,1247,-266
991,0,0,50,0,-50
992,1,0,13,0,-13
993,1,0,7,0,-7
994,1,1,120,1848,1728
995,1,0,76,0,-76
996,1,0,26,0,-26
997,1,1,112,1300,1188
998,0,0,11,0,-11
999,1,1,412,1363,951
1000,1,1,558,1250,692
1001,1,0,2,0,-2
1002,1,0,20,0,-20
1003,1,1,935,2000,1065
1004,1,1,841,1310,469
1005,0,0,37,0,-37
1006,1,1,370,1331,961
1007,1,0,2,0,-2
1008,0,0,79,0,-79
1009,1,1,1423,1397,-26
1010,1,1,378,2842,2464
1011,0,0,26,0,-26
1012,0,0,80,0,-80
1013,0,0,12,0,-12
1014,1,1,709,1629,920
1015,1,0,31,0,-31
1016,1,0,120,0,-120
1017,0,0,89,0,-89
1018,1,0,51,0,-51
1019,0,0,18,0,-18
1020,0,0,6,0,-6
1021,0,0,0,0,0
1022,0,0,51,0,-51
1023,1,1,239,1469,1230
1024,0,0,24,0,-24
1025,0,0,24,0,-24
1026,0,0,28,0,-28
1027,1,1,601,1418,817
1028,0,0,6,0,-6
1029,1,1,960,1336,376
1030,1,1,311,1334,1023
1031,1,0,137,0,-137
1032,1,0,17,0,-17
1033,1,0,33,0,-33
1034,0,0,12,0,-12
1035,1,0,17,0,-17
1036,0,0,107,0,-107
1037,1,1,592,1251,659
1038,1,1,323,1365,1042
1039,1,0,59,0,-59
1040,1,1,84,1217,1133
1041,1,0,145,0,-145
1042,1,0,48,0,-48
1043,1,1,132,2255,2123
1044,1,1,135,1706,1571
1045,1,1,1809,1253,-556
1046,0,0,20,0,-20
1047,1,0,112,0,-112
1048,1,1,379,1547,1168
1049,1,0,11,0,-11
1050,0,0,5,0,-5
1051,1,1,228,2201,1973
1052,0,0,14,0,-14
1053,0,0,55,0,-55
1054,1,1,972,1226,254
1055,1,0,9,0,-9
1056,0,0,63,0,-63
1057,0,0,51,0,-51
1058,0,0,60,0,-60
1059,1,0,0,0,0
1060,0,0,12,0,-12
1061,1,0,29,0,-29
1062,1,0,25,0,-25
1063,1,0,5,0,-5
1064,0,0,96,0,-96
1065,0,0,21,0,-21
1066,1,1,57,1466,1409
1067,0,0,48,0,-48
1068,1,1,397,1976,1579
1069,0,0,65,0,-65
1070,1,0,20,0,-20
1071,0,0,24,0,-24
1072,1,1,1241,1433,192
1073,1,1,2719,1430,-1289
1074,1,0,102,0,-102
1075,1,0,17,0,-17
1076,1,1,1030,1730,700
1077,1,0,53,0,-53
1078,1,0,8,0,-8
1079,0,0,59,0,-59
1080,1,0,50,0,-50
1081,1,1,1505,1298,-207
1082,0,0,45,0,-45
1083,1,1,46,1430,1384
1084,1,0,161,0,-161
1085,0,0,23,0,-23
1086,1,0,85,0,-85
1087,0,0,32,0,-32
1088,1,1,1460,1723,263
1089,0,0,45,0,-45
1090,1,0,22,0,-22
1091,1,0,134,0,-134
1092,1,1,97,3102,3005
1093,1,0,89,0,-89
1094,1,1,1518,1520,2
1095,0,0,153,0,-153
1096,1,0,10,0,-10
1097,1,1,1201,2016,815
1098,1,0,48,0,-48
1099,1,0,33,0,-33
1100,1,1,172,1336,1164
1101,1,1,342,1667,1325
1102,0,0,86,0,-86
1103,0,0,47,0,-47
1104,1,1,104,1324,1220
1105,0,0,19,0,-19
1106,1,0,73,0,-73
1107,1,0,42,0,-42
1108,1,0,71,0,-71
1109,0,0,45,0,-45
1110,1,1,297,1495,1198
1111,1,0,38,0,-38
1112,0,0,5,0,-5
1113,0,0,121,0,-121
1114,1,1,632,1777,1145
1115,0,0,14,0,-14
1116,0,0,43,0,-43
1117,0,0,72,0,-72
1118,1,0,100,0,-100
1119,1,0,10,0,-10
1120,0,0,31,0,-31
1121,1,0,25,0,-25
1122,0,0,9,0,-9
1123,1,0,31,0,-31
1124,1,1,110,1326,1216
1125,1,0,9,0,-9
1126,1,0,32,0,-32
1127,1,1,1067,1529,462
1128,0,0,6,0,-6
1129,1,1,1108,1470,362
1130,0,0,25,0,-25
1131,1,1,1337,1676,339
1132,1,1,1347,2877,1530
1133,0,0,29,0,-29
1134,1,1,777,1302,525
1135,1,0,31,0,-31
1136,1,1,223,1977,1754
1137,1,1,326,1635,1309
1138,1,0,84,0,-84
1139,1,1,305,1668,1363
1140,0,0,211,0,-211
1141,1,0,26,0,-26
1142,1,0,49,0,-49
1143,0,0,6,0,-6
1144,1,1,860,1735,875
1145,1,0,8,0,-8
1146,0,0,131,0,-131
1147,1,0,172,0,-172
1148,0,0,47,0,-47
1149,1,0,13,0,-13
1150,1,1,115,1320,1205
1151,1,1,117,1341,1224
1152,1,1,159,2387,2228
1153,0,0,58,0,-58
1154,1,0,1,0,-1
1155,0,0,43,0,-43
1156,0,0,13,0,-13
1157,1,0,19,0,-19
1158,1,0,17,0,-17
1159,0,0,92,0,-92
1160,1,1,672,1316,644
1161,0,0,95,0,-95
1162,0,0,119,0,-119
1163,0,0,10,0,-10
1164,0,0,2,0,-2
1165,1,1,2274,1609,-665
1166,0,0,20,0,-20
1167,1,1,2134,1548,-586
1168,1,0,8,0,-8
1169,0,0,25,0,-25
1170,0,0,10,0,-10
1171,1,0,70,0,-70
1172,1,0,92,0,-92
1173,0,0,124,0,-124
1174,1,1,244,1355,1111
1175,0,0,2,0,-2
1176,1,0,8,0,-8
1177,1,1,399,1270,871
1178,1,1,410,1279,869
1179,1,0,16,0,-16
1180,1,1,1631,1483,-148
1181,0,0,224,0,-224
1182,1,0,9,0,-9
1183,0,0,2,0,-2
1184,0,0,22,0,-22
1185,1,1,101,1885,1784
1186,1,0,69,0,-69
1187,1,0,12,0,-12
1188,0,0,2,0,-2
1189,0,0,83,0,-83
1190,1,1,472,1739,1267
1191,0,0,0,0,0
1192,0,0,13,0,-13
1193,0,0,81,0,-81
1194,1,0,42,0,-42
1195,1,0,11,0,-11
1196,1,0,230,0,-230
1197,1,1,420,2167,1747
1198,1,0,28,0,-28
1199,0,0,52,0,-52
1200,1,1,203,1256,1053
1201,1,1,515,1896,1381
1202,1,0,106,0,-106
1203,0,0,49,0,-49
1204,1,1,189,1305,1116
1205,1,0,56,0,-56
1206,0,0,40,0,-40
1207,1,0,32,0,-32
1208,0,0,79,0,-79
1209,0,0,10,0,-10
1210,1,1,297,1400,1103
1211,0,0,13,0,-13
1212,1,1,181,1431,1250
1213,0,0,59,0,-59
1214,1,1,1079,1209,130
1215,1,1,235,1461,1226
1216,0,0,104,0,-104
1217,0,0,14,0,-14
1218,0,0,18,0,-18
1219,0,0,2,0,-2
1220,1,1,1094,1379,285
1221,0,0,119,0,-119
1222,1,0,105,0,-105
1223,1,0,60,0,-60
1224,1,0,40,0,-40
1225,1,0,56,0,-56
1226,0,0,49,0,-49
1227,0,0,6,0,-6
1228,1,0,7,0,-7
1229,1,1,360,2019,1659
1230,1,0,36,0,-36
1231,0,0,28,0,-28
1232,1,0,39,0,-39
1233,1,1,448,1353,905
1234,1,1,86,1383,1297
1235,0,0,8,0,-8
1236,1,1,918,2211,1293
1237,0,0,3,0,-3
1238,1,1,838,1278,440
1239,0,0,50,0,-50
1240,0,0,47,0,-47
1241,1,0,4,0,-4
1242,0,0,5,0,-5
1243,1,0,62,0,-62
1244,1,1,1055,1299,244
1245,1,0,5,0,-5
1246,1,1,576,1863,1287
1247,1,1,534,1554,1020
1248,1,1,725,2719,1994
1249,1,0,71,0,-71
1250,1,1,1337,1290,-47
1251,1,0,7,0,-7
1252,0,0,28,0,-28
1253,1,0,4,0,-4
1254,0,0,35,0,-35
1255,0,0,34,0,-34
1256,1,1,556,1585,1029
1257,1,0,65,0,-65
1258,1,1,82,1619,1537
1259,0,0,24,0,-24
1260,1,0,64,0,-64
1261,1,0,12,0,-12
1262,0,0,67,0,-67
1263,0,0,27,0,-27
1264,0,0,49,0,-49
1265,0,0,38,0,-38
1266,1,1,64,1257,1193
1267,0,0,2,0,-2
1268,0,0,13,0,-13
1269,1,0,9,0,-9
1270,0,0,3,0,-3
1271,1,0,107,0,-107
1272,1,1,720,1529,809
1273,1,0,21,0,-21
1274,0,0,63,0,-63
1275,0,0,20,0,-20
1276,0,0,34,0,-34
1277,1,1,675,1390,715
1278,0,0,2,0,-2
1279,1,0,191,0,-191
1280,1,1,505,2486,1981
1281,0,0,46,0,-46
1282,1,1,767,1860,1093
1283,1,1,155,1588,1433
1284,1,0,5,0,-5
1285,0,0,30,0,-30
1286,1,0,64,0,-64
1287,1,1,476,1224,748
1288,0,0,32,0,-32
1289,1,1,164,1229,1065
1290,1,0,65,0,-65
1291,0,0,150,0,-150
1292,1,1,967,1211,244
1293,1,1,95,2526,2431
1294,1,1,784,7169,6385
1295,1,1,325,2611,2286
1296,1,1,2787,1254,-1533
1297,0,0,74,0,-74
1298,1,0,11,0,-11
1299,1,0,15,0,-15
1300,0,0,179,0,-179
1301,1,1,1039,1321,282
1302,0,0,41,0,-41
1303,1,0,102,0,-102
1304,1,0,14,0,-14
1305,0,0,8,0,-8
1306,0,0,20,0,-20
1307,1,1,564,2037,1473
1308,0,0,7,0,-7
1309,1,1,1542,1329,-213
1310,1,0,32,0,-32
1311,1,0,33,0,-33
1312,1,1,197,2335,2138
1313,1,1,856,2210,1354
1314,1,0,57,0,-57
1315,0,0,117,0,-117
1316,1,0,11,0,-11
1317,1,0,25,0,-25
1318,0,0,65,0,-65
1319,1,0,39,0,-39
1320,0,0,25,0,-25
1321,1,0,10,0,-10
1322,0,0,15,0,-15
1323,0,0,10,0,-10
1324,0,0,11,0,-11
1325,0,0,60,0,-60
1326,1,0,61,0,-61
1327,1,1,111,2276,2165
1328,1,1,1834,1233,-601
1329,0,0,34,0,-34
1330,0,0,7,0,-7
1331,1,1,7,1437,1430
1332,1,0,23,0,-23
1333,0,0,56,0,-56
1334,1,0,4,0,-4
1335,0,0,123,0,-123
1336,1,0,183,0,-183
1337,0,0,87,0,-87
1338,1,0,104,0,-104
1339,1,0,47,0,-47
1340,0,0,58,0,-58
1341,0,0,8,0,-8
1342,1,1,122,2201,2079
1343,0,0,35,0,-35
1344,1,1,820,1944,1124
1345,1,0,291,0,-291
1346,0,0,204,0,-204
1347,0,0,51,0,-51
1348,1,1,80,1207,1127
1349,1,1,1191,1374,183
1350,0,0,65,0,-65
1351,1,1,1011,2229,1218
1352,1,1,215,1650,1435
1353,1,1,1248,1994,746
1354,1,0,33,0,-33
1355,0,0,33,0,-33
1356,0,0,50,0,-50
1357,0,0,1,0,-1
1358,0,0,19,0,-19
1359,1,1,100,1226,1126
1360,0,0,138,0,-138
1361,1,1,389,1498,1109
1362,0,0,24,0,-24
1363,1,0,107,0,-107
1364,1,0,45,0,-45
1365,1,0,40,0,-40
1366,1,1,101,2186,2085
1367,0,0,3,0,-3
1368,1,0,14,0,-14
1369,0,0,15,0,-15
1370,0,0,86,0,-86
1371,1,1,166,1263,1097
1372,1,0,13,0,-13
1373,1,1,993,1373,380
1374,0,0,27,0,-27
1375,0,0,11,0,-11
1376,0,0,4,0,-4
1377,1,1,585,1533,948
1378,1,0,43,0,-43
1379,1,1,735,1219,484
1380,1,0,29,0,-29
1381,1,1,151,1553,1402
1382,1,0,19,0,-19
1383,1,0,64,0,-64
1384,1,1,286,1271,985
1385,1,0,63,0,-63
1386,0,0,19,0,-19
1387,1,0,190,0,-190
1388,1,1,821,1269,448
1389,1,1,2486,2270,-216
1390,0,0,60,0,-60
1391,0,0,22,0,-22
1392,0,0,31,0,-31
1393,1,0,161,0,-161
1394,0,0,2,0,-2
1395,1,1,252,1457,1205
1396,1,0,22,0,-22
1397,1,0,22,0,-22
1398,0,0,123,0,-123
1399,0,0,107,0,-107
1400,1,0,24,0,-24
1401,0,0,20,0,-20
1402,0,0,30,0,-30
1403,0,0,111,0,-111
1404,0,0,46,0,-46
1405,1,0,65,0,-65
1406,1,0,8,0,-8
1407,1,1,750,2614,1864
1408,0,0,32,0,-32
1409,0,0,4,0,-4
1410,1,0,33,0,-33
1411,1,0,36,0,-36
1412,1,0,50,0,-50
1413,1,1,178,1426,1248
1414,1,0,60,0,-60
1415,0,0,26,0,-26
1416,1,1,522,2241,1719
1417,1,0,47,0,-47
1418,1,0,47,0,-47
1419,1,1,514,1593,1079
1420,1,1,161,2551,2390
1421,1,1,131,1305,1174
1422,0,0,58,0,-58
1423,0,0,60,0,-60
1424,0,0,151,0,-151
1425,1,0,5,0,-5
1426,1,1,169,2157,1988
1427,0,0,3,0,-3
1428,1,0,58,0,-58
1429,1,1,103,1242,1139
1430,1,0,7,0,-7
1431,1,0,5,0,-5
1432,1,0,49,0,-49
1433,1,0,33,0,-33
1434,1,0,122,0,-122
1435,1,0,4,0,-4
1436,1,1,99,1260,1161
1437,0,0,35,0,-35
1438,0,0,33,0,-33
1439,1,0,8,0,-8
1440,0,0,10,0,-10
1441,1,0,49,0,-49
1442,0,0,3,0,-3
1443,0,0,36,0,-36
1444,1,1,213,2267,2054
1445,0,0,75,0,-75
1446,0,0,48,0,-48
1447,0,0,59,0,-59
1448,0,0,35,0,-35
1449,1,1,1209,1584,375
1450,0,0,34,0,-34
1451,0,0,97,0,-97
1452,1,1,1347,1282,-65
1453,1,1,424,3149,2725
1454,1,1,43,1723,1680
1455,1,1,598,1257,659
1456,1,1,3348,2031,-1317
1457,1,1,506,1228,722
1458,0,0,3,0,-3
1459,1,1,29,1201,1172
1460,1,0,19,0,-19
1461,1,0,76,0,-76
1462,1,0,16,0,-16
1463,0,0,63,0,-63
1464,1,1,1161,1257,96
1465,1,1,1065,1211,146
1466,1,1,1398,1392,-6
1467,0,0,84,0,-84
1468,1,0,140,0,-140
1469,1,1,261,1356,1095
1470,1,1,490,2955,2465
1471,0,0,35,0,-35
1472,0,0,97,0,-97
1473,1,1,67,1725,1658
1474,1,1,1356,2584,1228
1475,0,0,5,0,-5
1476,1,0,246,0,-246
1477,1,1,770,1338,568
1478,1,0,21,0,-21
1479,0,0,21,0,-21
1480,0,0,15,0,-15
1481,0,0,60,0,-60
1482,1,0,63,0,-63
1483,0,0,24,0,-24
1484,0,0,90,0,-90
1485,0,0,1,0,-1
1486,0,0,27,0,-27
1487,1,1,498,1382,884
1488,0,0,24,0,-24
1489,1,0,156,0,-156
1490,1,1,634,1277,643
1491,0,0,15,0,-15
1492,1,0,2,0,-2
1493,1,0,31,0,-31
1494,1,0,74,0,-74
1495,1,0,55,0,-55
1496,0,0,10,0,-10
1497,0,0,24,0,-24
1498,1,0,34,0,-34
1499,0,0,208,0,-208
1500,1,0,87,0,-87
1501,1,1,703,1284,581
1502,1,0,29,0,-29
1503,1,1,294,1860,1566
1504,1,0,7,0,-7
1505,1,0,31,0,-31
1506,0,0,62,0,-62
1507,1,1,3542,1272,-2270
1508,0,0,47,0,-47
1509,1,1,1145,1261,116
1510,1,1,570,1859,1289
1511,1,1,534,1240,706
1512,1,0,113,0,-113
1513,0,0,3,0,-3
1514,0,0,23,0,-23
1515,1,1,315,1228,913
1516,1,0,20,0,-20
1517,1,0,8,0,-8
1518,0,0,75,0,-75
1519,0,0,49,0,-49
1520,0,0,9,0,-9
1521,1,1,494,1440,946
1522,0,0,23,0,-23
1523,1,0,141,0,-141
1524,1,0,32,0,-32
1525,0,0,52,0,-52
1526,0,0,18,0,-18
1527,0,0,8,0,-8
1528,0,0,86,0,-86
1529,1,0,13,0,-13
1530,1,1,161,1593,1432
1531,0,0,44,0,-44
1532,0,0,19,0,-19
1533,1,0,0,0,0
1534,1,0,36,0,-36
1535,1,1,518,1253,735
1536,0,0,1,0,-1
1537,1,1,129,3031,2902
1538,0,0,105,0,-105
1539,1,0,39,0,-39
1540,0,0,14,0,-14
1541,0,0,9,0,-9
1542,0,0,50,0,-50
1543,1,0,2,0,-2
1544,0,0,44,0,-44
1545,1,1,983,1658,675
1546,0,0,6,0,-6
1547,0,0,6,0,-6
1548,1,0,0,0,0
1549,1,0,88,0,-88
1550,0,0,81,0,-81
1551,0,0,153,0,-153
1552,0,0,24,0,-24
1553,1,0,45,0,-45
1554,1,1,147,1215,1068
1555,0,0,145,0,-145
1556,0,0,4,0,-4
1557,1,1,147,1491,1344
1558,1,1,1061,1713,652
1559,0,0,22,0,-22
1560,1,0,4,0,-4
1561,1,0,7,0,-7
1562,0,0,34,0,-34
1563,1,1,521,2709,2188
1564,1,0,39,0,-39
1565,1,0,18,0,-18
1566,0,0,44,0,-44
1567,1,0,60,0,-60
1568,1,1,216,1597,1381
1569,1,0,47,0,-47
1570,1,0,51,0,-51
1571,1,0,92,0,-92
1572,1,0,76,0,-76
1573,1,0,113,0,-113
1574,0,0,45,0,-45
1575,1,0,7,0,-7
1576,1,1,267,1786,1519
1577,1,1,182,1690,1508
1578,1,0,42,0,-42
1579,0,0,26,0,-26
1580,1,1,415,1229,814
1581,1,1,1904,1644,-260
1582,1,1,884,1215,331
1583,1,0,10,0,-10
1584,1,0,98,0,-98
1585,1,1,402,2205,1803
1586,1,0,6,0,-6
1587,1,0,45,0,-45
1588,0,0,1,0,-1
1589,0,0,62,0,-62
1590,0,0,4,0,-4
1591,1,1,1495,1601,106
1592,1,0,13,0,-13
1593,0,0,99,0,-99
1594,1,0,11,0,-11
1595,0,0,84,0,-84
1596,1,0,6,0,-6
1597,1,0,44,0,-44
1598,0,0,35,0,-35
1599,1,0,100,0,-100
1600,0,0,50,0,-50
1601,1,0,4,0,-4
1602,0,0,87,0,-87
1603,1,0,25,0,-25
1604,0,0,6,0,-6
1605,0,0,8,0,-8
1606,1,1,1504,1533,29
1607,0,0,45,0,-45
1608,0,0,55,0,-55
1609,0,0,90,0,-90
1610,1,0,103,0,-103
1611,1,0,181,0,-181
1612,0,0,41,0,-41
1613,0,0,85,0,-85
1614,1,1,228,1240,1012
1615,1,0,22,0,-22
1616,0,0,14,0,-14
1617,0,0,12,0,-12
1618,1,1,694,2466,1772
1619,0,0,12,0,-12
1620,0,0,9,0,-9
1621,1,0,57,0,-57
1622,0,0,104,0,-104
1623,0,0,34,0,-34
1624,0,0,5,0,-5
1625,1,0,56,0,-56
1626,0,0,19,0,-19
1627,0,0,90,0,-90
1628,1,0,62,0,-62
1629,0,0,9,0,-9
1630,1,1,193,1298,1105
1631,0,0,6,0,-6
1632,1,0,154,0,-154
1633,1,0,48,0,-48
1634,1,1,269,1762,1493
1635,1,1,192,1524,1332
1636,1,1,251,1646,1395
1637,1,0,2,0,-2
1638,0,0,68,0,-68
1639,1,1,1520,1575,55
1640,0,0,70,0,-70
1641,1,0,9,0,-9
1642,1,1,544,2143,1599
1643,1,0,7,0,-7
1644,1,0,135,0,-135
1645,1,0,15,0,-15
1646,1,1,220,1206,986
1647,1,1,202,1448,1246
1648,0,0,85,0,-85
1649,1,0,62,0,-62
1650,1,1,122,2260,2138
1651,1,0,217,0,-217
1652,1,0,128,0,-128
1653,1,0,8,0,-8
1654,0,0,3,0,-3
1655,1,1,165,1394,1229
1656,1,1,6,1665,1659
1657,1,0,45,0,-45
1658,1,0,31,0,-31
1659,1,1,533,1279,746
1660,1,0,18,0,-18
1661,0,0,13,0,-13
1662,1,1,32,1596,1564
1663,0,0,25,0,-25
1664,1,0,29,0,-29
1665,1,0,24,0,-24
1666,1,0,69,0,-69
1667,1,0,5,0,-5
1668,1,1,582,1505,923
1669,1,0,12,0,-12
1670,1,1,69,1627,1558
1671,1,0,68,0,-68
1672,1,0,68,0,-68
1673,1,1,206,1307,1101
1674,1,0,24,0,-24
1675,1,1,312,1329,1017
1676,0,0,15,0,-15
1677,1,0,91,0,-91
1678,1,1,812,1918,1106
1679,0,0,52,0,-52
1680,1,0,47,0,-47
1681,1,0,0,0,0
1682,1,0,134,0,-134
1683,1,0,28,0,-28
1684,0,0,78,0,-78
1685,0,0,38,0,-38
1686,0,0,47,0,-47
1687,1,1,30,1667,1637
1688,0,0,92,0,-92
1689,1,1,759,3080,2321
1690,0,0,38,0,-38
1691,1,0,8,0,-8
1692,1,0,54,0,-54
1693,1,1,782,1826,1044
1694,0,0,37,0,-37
1695,1,1,299,1309,1010
1696,1,0,14,0,-14
1697,1,0,46,0,-46
1698,0,0,22,0,-22
1699,0,0,59,0,-59
1700,0,0,44,0,-44
1701,1,0,34,0,-34
1702,0,0,21,0,-21
1703,1,1,306,1292,986
1704,1,1,30,1207,1177
1705,1,1,136,1476,1340
1706,1,0,26,0,-26
1707,0,0,79,0,-79
1708,1,0,2,0,-2
1709,1,1,47,1509,1462
1710,0,0,16,0,-16
1711,1,1,377,1281,904
1712,1,1,402,1584,1182
1713,1,0,60,0,-60
1714,0,0,22,0,-22
1715,0,0,16,0,-16
1716,0,0,142,0,-142
1717,1,1,364,1353,989
1718,1,0,64,0,-64
1719,1,0,47,0,-47
1720,1,0,32,0,-32
1721,1,1,777,1202,425
1722,0,0,9,0,-9
1723,1,1,91,1320,1229
1724,1,1,40,2884,2844
1725,0,0,2,0,-2
1726,1,1,1589,1647,58
1727,1,0,5,0,-5
1728,1,0,5,0,-5
1729,1,0,38,0,-38
1730,1,0,50,0,-50
1731,1,1,251,2076,1825
1732,1,0,9,0,-9
1733,1,1,2182,1619,-563
1734,1,0,366,0,-366
1735,1,0,8,0,-8
1736,0,0,11,0,-11
1737,1,0,33,0,-33
1738,1,1,1983,1577,-406
1739,1,1,923,1495,572
1740,1,0,25,0,-25
1741,1,0,110,0,-110
1742,1,0,11,0,-11
1743,1,0,42,0,-42
1744,1,0,17,0,-17
1745,0,0,0,0,0
1746,1,0,23,0,-23
1747,1,0,52,0,-52
1748,0,0,39,0,-39
1749,1,0,0,0,0
1750,0,0,95,0,-95
1751,0,0,38,0,-38
1752,1,1,78,1215,1137
1753,1,1,138,1669,1531
1754,1,1,1572,1367,-205
1755,0,0,100,0,-100
1756,1,1,100,1353,1253
1757,1,0,42,0,-42
1758,0,0,64,0,-64
1759,1,1,101,1848,1747
1760,1,1,2067,1334,-733
1761,1,0,3,0,-3
1762,0,0,61,0,-61
1763,1,0,4,0,-4
1764,1,1,1707,1306,-401
1765,1,0,28,0,-28
1766,1,1,355,1331,976
1767,0,0,27,0,-27
1768,1,0,40,0,-40
1769,1,0,48,0,-48
1770,1,0,38,0,-38
1771,0,0,32,0,-32
1772,1,1,936,1497,561
1773,1,1,461,1398,937
1774,0,0,7,0,-7
1775,1,0,96,0,-96
1776,0,0,153,0,-153
1777,0,0,110,0,-110
1778,0,0,53,0,-53
1779,0,0,46,0,-46
1780,1,0,210,0,-210
1781,1,1,403,1445,1042
1782,1,1,1033,1211,178
1783,1,0,102,0,-102
1784,1,1,650,1244,594
1785,0,0,20,0,-20
1786,1,0,62,0,-62
1787,0,0,9,0,-9
1788,0,0,34,0,-34
1789,0,0,126,0,-126
1790,1,0,71,0,-71
1791,0,0,8,0,-8
1792,1,1,496,1424,928
1793,1,0,4,0,-4
1794,1,0,117,0,-117
1795,0,0,13,0,-13
1796,0,0,244,0,-244
1797,0,0,9,0,-9
1798,1,0,136,0,-136
1799,1,1,1514,1757,243
1800,1,0,14,0,-14
1801,1,0,20,0,-20
1802,1,1,607,1322,715
1803,0,0,11,0,-11
1804,1,0,24,0,-24
1805,0,0,88,0,-88
1806,0,0,18,0,-18
1807,0,0,112,0,-112
1808,1,1,39,1208,1169
1809,1,1,993,1605,612
1810,1,1,28,1267,1239
1811,0,0,22,0,-22
1812,0,0,44,0,-44
1813,1,0,16,0,-16
1814,1,0,277,0,-277
1815,0,0,65,0,-65
1816,0,0,58,0,-58
1817,1,0,47,0,-47
1818,0,0,38,0,-38
1819,0,0,7,0,-7
1820,1,0,13,0,-13
1821,1,0,11,0,-11
1822,0,0,32,0,-32
1823,0,0,83,0,-83
1824,1,1,663,2024,1361
1825,1,0,26,0,-26
1826,1,0,215,0,-215
1827,0,0,88,0,-88
1828,1,0,24,0,-24
1829,1,1,271,1599,1328
1830,1,0,1,0,-1
1831,1,0,159,0,-159
1832,1,1,19,1349,1330
1833,1,1,90,1293,1203
1834,0,0,38,0,-38
1835,0,0,42,0,-42
1836,1,0,41,0,-41
1837,0,0,42,0,-42
1838,0,0,13,0,-13
1839,1,0,0,0,0
1840,1,0,56,0,-56
1841,1,1,22,3453,3431
1842,1,1,855,1603,748
1843,1,1,114,1300,1186
1844,1,0,144,0,-144
1845,1,0,12,0,-12
1846,0,0,161,0,-161
1847,1,0,68,0,-68
1848,0,0,20,0,-20
1849,1,0,95,0,-95
1850,0,0,99,0,-99
1851,0,0,7,0,-7
1852,1,1,1200,1537,337
1853,1,1,408,1346,938
1854,1,0,14,0,-14
1855,0,0,87,0,-87
1856,0,0,49,0,-49
1857,0,0,14,0,-14
1858,0,0,44,0,-44
1859,1,0,21,0,-21
1860,0,0,7,0,-7
1861,1,1,285,1696,1411
1862,0,0,88,0,-88
1863,1,1,174,1443,1269
1864,0,0,67,0,-67
1865,0,0,69,0,-69
1866,0,0,119,0,-119
1867,0,0,292,0,-292
1868,1,1,114,1292,1178
1869,0,0,37,0,-37
1870,0,0,330,0,-330
1871,1,1,141,1368,1227
1872,1,1,524,1268,744
1873,0,0,35,0,-35
1874,1,1,955,1287,332
1875,0,0,6,0,-6
1876,1,1,1132,1356,224
1877,1,0,28,0,-28
1878,0,0,89,0,-89
1879,0,0,11,0,-11
1880,1,1,857,1303,446
1881,1,1,718,1403,685
1882,1,1,103,1232,1129
1883,0,0,23,0,-23
1884,1,0,32,0,-32
1885,1,0,14,0,-14
1886,1,0,13,0,-13
1887,1,1,533,1605,1072
1888,0,0,20,0,-20
1889,0,0,12,0,-12
1890,1,0,8,0,-8
1891,1,0,22,0,-22
1892,1,1,432,1491,1059
1893,0,0,86,0,-86
1894,1,0,38,0,-38
1895,1,0,10,0,-10
1896,1,0,28,0,-28
1897,0,0,14,0,-14
1898,0,0,36,0,-36
1899,1,1,1759,1410,-349
1900,1,0,20,0,-20
1901,0,0,22,0,-22
1902,1,1,52,3211,3159
1903,0,0,15,0,-15
1904,1,1,230,1218,988
1905,1,1,620,1485,865
1906,0,0,101,0,-101
1907,0,0,5,0,-5
1908,1,0,32,0,-32
1909,1,1,1294,1215,-79
1910,1,1,39,1250,1211
1911,1,0,117,0,-117
1912,1,1,104,1350,1246
1913,0,0,36,0,-36
1914,1,0,5,0,-5
1915,1,1,222,1593,1371
1916,0,0,73,0,-73
1917,0,0,57,0,-57
1918,0,0,4,0,-4
1919,0,0,199,0,-199
1920,1,0,5,0,-5
1921,0,0,245,0,-245
1922,0,0,79,0,-79
1923,1,1,237,1261,1024
1924,0,0,51,0,-51
1925,1,0,24,0,-24
1926,0,0,27,0,-27
1927,1,0,44,0,-44
1928,0,0,21,0,-21
1929,1,0,38,0,-38
1930,1,1,649,1217,568
1931,1,1,384,1223,839
1932,1,0,5,0,-5
1933,1,1,85,1342,1257
1934,1,0,25,0,-25
1935,0,0,95,0,-95
1936,0,0,2,0,-2
1937,1,1,499,1241,742
1938,0,0,8,0,-8
1939,0,0,22,0,-22
1940,1,1,194,1206,1012
1941,0,0,49,0,-49
1942,1,0,0,0,0
1943,1,0,25,0,-25
1944,1,0,24,0,-24
1945,1,1,620,2013,1393
1946,0,0,2,0,-2
1947,1,0,223,0,-223
1948,0,0,132,0,-132
1949,0,0,8,0,-8
1950,1,1,393,1342,949
1951,1,1,88,1390,1302
1952,0,0,136,0,-136
1953,1,0,6,0,-6
1954,1,1,181,1452,1271
1955,1,0,24,0,-24
1956,1,0,19,0,-19
1957,1,1,201,2003,1802
1958,1,1,503,1279,776
1959,1,0,10,0,-10
1960,1,1,261,1855,1594
1961,1,1,319,1340,1021
1962,1,1,2579,1490,-1089
1963,1,0,36,0,-36
1964,1,1,1911,4983,3072
1965,0,0,12,0,-12
1966,1,1,399,1332,933
1967,1,0,3,0,-3
1968,0,0,24,0,-24
1969,1,1,500,1783,1283
1970,1,1,684,1408,724
1971,1,0,99,0,-99
1972,0,0,51,0,-51
1973,0,0,12,0,-12
1974,1,1,1036,1275,239
1975,1,1,2291,1449,-842
1976,0,0,37,0,-37
1977,1,0,17,0,-17
1978,0,0,9,0,-9
1979,0,0,8,0,-8
1980,1,1,1585,1322,-263
1981,1,0,58,0,-58
1982,1,0,133,0,-133
1983,1,1,260,1686,1426
1984,1,0,88,0,-88
1985,1,0,259,0,-259
1986,0,0,73,0,-73
1987,0,0,21,0,-21
1988,1,0,157,0,-157
1989,1,1,78,1378,1300
1990,0,0,36,0,-36
1991,0,0,42,0,-42
1992,1,0,55,0,-55
1993,0,0,14,0,-14
1994,1,1,682,2041,1359
1995,0,0,26,0,-26
1996,0,0,15,0,-15
1997,0,0,3,0,-3
1998,0,0,51,0,-51
1999,1,0,25,0,-25
2000,1,0,82,0,-82
2001,0,0,66,0,-66
2002,0,0,39,0,-39
2003,0,0,78,0,-78
2004,1,1,188,1677,1489
2005,0,0,143,0,-143
2006,0,0,41,0,-41
2007,0,0,106,0,-106
2008,0,0,134,0,-134
2009,0,0,136,0,-136
2010,0,0,46,0,-46
2011,1,1,46,1447,1401
2012,0,0,75,0,-75
2013,0,0,35,0,-35
2014,0,0,51,0,-51
2015,1,0,14,0,-14
2016,0,0,20,0,-20
2017,0,0,55,0,-55
2018,1,1,114,1334,1220
2019,1,1,933,1326,393
2020,1,0,14,0,-14
2021,1,0,56,0,-56
2022,0,0,93,0,-93
2023,0,0,85,0,-85
2024,0,0,56,0,-56
2025,0,0,1,0,-1
2026,1,0,51,0,-51
2027,1,0,28,0,-28
2028,0,0,67,0,-67
2029,1,0,49,0,-49
2030,0,0,24,0,-24
2031,0,0,50,0,-50
2032,0,0,24,0,-24
2033,1,0,2,0,-2
2034,0,0,58,0,-58
2035,0,0,112,0,-112
2036,1,1,243,1478,1235
2037,1,0,8,0,-8
2038,0,0,13,0,-13
2039,0,0,96,0,-96
2040,0,0,16,0,-16
2041,1,1,58,1218,1160
2042,1,0,19,0,-19
2043,0,0,0,0,0
2044,1,0,20,0,-20
2045,0,0,2,0,-2
2046,1,1,1,1720,1719
2047,1,0,26,0,-26
2048,0,0,8,0,-8
2049,1,1,477,1818,1341
2050,1,1,1200,1234,34
2051,0,0,144,0,-144
2052,0,0,12,0,-12
2053,0,0,24,0,-24
2054,0,0,12,0,-12
2055,1,0,0,0,0
2056,1,0,61,0,-61
2057,0,0,134,0,-134
2058,0,0,52,0,-52
2059,1,1,256,1337,1081
2060,1,1,797,1283,486
2061,0,0,7,0,-7
2062,1,0,9,0,-9
2063,1,0,4,0,-4
2064,1,0,260,0,-260
2065,0,0,39,0,-39
2066,0,0,5,0,-5
2067,0,0,79,0,-79
2068,1,0,147,0,-147
2069,1,0,22,0,-22
2070,1,0,53,0,-53
2071,1,1,189,1758,1569
2072,1,0,16,0,-16
2073,0,0,64,0,-64
2074,1,0,14,0,-14
2075,1,1,1412,1382,-30
2076,1,0,51,0,-51
2077,1,0,45,0,-45
2078,1,0,30,0,-30
2079,0,0,57,0,-57
2080,1,0,68,0,-68
2081,1,0,32,0,-32
2082,1,1,183,1257,1074
2083,0,0,132,0,-132
2084,0,0,62,0,-62
2085,0,0,52,0,-52
2086,1,1,283,1296,1013
2087,1,0,2,0,-2
2088,1,1,368,1683,1315
2089,0,0,8,0,-8
2090,0,0,35,0,-35
2091,0,0,55,0,-55
2092,1,1,1255,1464,209
2093,0,0,68,0,-68
2094,0,0,1,0,-1
2095,0,0,155,0,-155
2096,1,0,61,0,-61
2097,1,0,3,0,-3
2098,1,1,166,1204,1038
2099,1,0,2,0,-2
2100,1,0,26,0,-26
2101,1,0,1,0,-1
2102,0,0,106,0,-106
2103,0,0,120,0,-120
2104,1,1,348,1273,925
2105,0,0,39,0,-39
2106,1,1,684,1398,714
2107,1,0,45,0,-45
2108,0,0,25,0,-25
2109,1,1,675,1936,1261
2110,1,1,1156,1239,83
2111,1,1,605,1200,595
2112,1,0,10,0,-10
2113,1,1,361,2601,2240
2114,1,1,1017,2304,1287
2115,1,0,17,0,-17
2116,1,0,6,0,-6
2117,1,0,24,0,-24
2118,1,0,98,0,-98
2119,1,1,253,2008,1755
2120,0,0,73,0,-73
2121,0,0,16,0,-16
2122,0,0,5,0,-5
2123,1,1,335,1383,1048
2124,1,1,498,1249,751
2125,1,0,99,0,-99
2126,1,1,213,1219,1006
2127,1,1,514,2121,1607
2128,1,1,568,2648,2080
2129,0,0,1,0,-1
2130,0,0,19,0,-19
2131,0,0,86,0,-86
2132,1,1,482,1232,750
2133,1,1,587,1495,908
2134,0,0,41,0,-41
2135,0,0,36,0,-36
2136,1,1,528,1477,949
2137,0,0,27,0,-27
2138,1,0,79,0,-79
2139,1,0,144,0,-144
2140,0,0,129,0,-129
2141,1,0,23,0,-23
2142,1,1,1714,1386,-328
2143,1,0,45,0,-45
2144,0,0,111,0,-111
2145,0,0,30,0,-30
2146,0,0,0,0,0
2147,1,1,263,1375,1112
2148,0,0,2,0,-2
2149,1,1,117,1761,1644
2150,1,0,19,0,-19
2151,1,0,113,0,-113
2152,0,0,92,0,-92
2153,0,0,82,0,-82
2154,1,0,32,0,-32
2155,1,0,29,0,-29
2156,0,0,142,0,-142
2157,1,1,507,1336,829
2158,1,1,148,1629,1481
2159,1,0,56,0,-56
2160,0,0,8,0,-8
2161,1,1,532,1263,731
2162,1,1,1269,1440,171
2163,1,0,25,0,-25
2164,1,1,572,1661,1089
2165,0,0,73,0,-73
2166,1,0,78,0,-78
2167,1,0,0,0,0
2168,0,0,14,0,-14
2169,1,1,186,1292,1106
2170,1,1,445,1492,1047
2171,0,0,66,0,-66
2172,1,0,24,0,-24
2173,1,1,1020,1963,943
2174,0,0,3,0,-3
2175,1,1,60,1503,1443
2176,1,0,0,0,0
2177,0,0,77,0,-77
2178,1,0,69,0,-69
2179,1,0,23,0,-23
2180,0,0,24,0,-24
2181,0,0,184,0,-184
2182,1,0,167,0,-167
2183,0,0,88,0,-88
2184,1,1,308,1460,1152
2185,0,0,52,0,-52
2186,0,0,51,0,-51
2187,0,0,57,0,-57
2188,1,1,607,1828,1221
2189,1,0,17,0,-17
2190,1,0,33,0,-33
2191,1,1,223,1427,1204
2192,1,0,17,0,-17
2193,0,0,51,0,-51
2194,0,0,28,0,-28
2195,0,0,217,0,-217
2196,0,0,34,0,-34
2197,0,0,2,0,-2
2198,0,0,60,0,-60
2199,1,0,11,0,-11
2200,1,0,17,0,-17
2201,0,0,28,0,-28
2202,1,0,16,0,-16
2203,1,1,832,1286,454
2204,1,1,1574,1375,-199
2205,0,0,40,0,-40
2206,1,0,95,0,-95
2207,1,0,1,0,-1
2208,0,0,17,0,-17
2209,0,0,25,0,-25
2210,1,0,117,0,-117
2211,1,0,50,0,-50
2212,0,0,0,0,0
2213,1,1,952,1670,718
2214,1,1,464,1325,861
2215,0,0,25,0,-25
2216,0,0,67,0,-67
2217,1,1,90,1424,1334
2218,0,0,194,0,-194
2219,1,0,105,0,-105
2220,1,0,64,0,-64
2221,1,0,168,0,-168
2222,1,0,11,0,-11
2223,1,1,101,1574,1473
2224,1,1,485,1373,888
2225,1,0,27,0,-27
2226,1,0,38,0,-38
2227,0,0,8,0,-8
2228,1,0,17,0,-17
2229,0,0,58,0,-58
2230,0,0,40,0,-40
2231,0,0,19,0,-19
2232,1,0,31,0,-31
2233,0,0,4,0,-4
2234,1,1,93,1293,1200
2235,1,1,66,1549,1483
2236,1,0,181,0,-181
2237,1,0,32,0,-32
2238,0,0,27,0,-27
2239,1,0,16,0,-16
2240,0,0,246,0,-246
2241,1,1,392,1412,1020
2242,0,0,35,0,-35
2243,0,0,188,0,-188
2244,1,0,6,0,-6
2245,0,0,1,0,-1
2246,0,0,39,0,-39
2247,1,0,12,0,-12
2248,1,0,80,0,-80
2249,1,1,325,1345,1020
2250,1,0,14,0,-14
2251,1,1,618,1303,685
2252,1,0,38,0,-38
2253,0,0,207,0,-207
2254,1,1,348,1872,1524
2255,0,0,66,0,-66
2256,0,0,14,0,-14
2257,1,0,24,0,-24
2258,1,1,659,1886,1227
2259,1,1,463,1457,994
2260,0,0,56,0,-56
2261,1,1,246,1440,1194
2262,1,0,87,0,-87
2263,1,0,17,0,-17
2264,1,0,48,0,-48
2265,0,0,96,0,-96
2266,1,0,48,0,-48
2267,0,0,42,0,-42
2268,0,0,34,0,-34
2269,1,0,15,0,-15
2270,1,0,57,0,-57
2271,1,0,88,0,-88
2272,1,0,54,0,-54
2273,1,1,911,1357,446
2274,1,1,990,1346,356
2275,1,1,763,1210,447
2276,0,0,141,0,-141
2277,1,0,18,0,-18
2278,1,1,927,1493,566
2279,1,1,1915,1264,-651
2280,1,1,968,1306,338
2281,0,0,100,0,-100
2282,1,0,80,0,-80
2283,1,0,103,0,-103
2284,0,0,124,0,-124
2285,0,0,31,0,-31
2286,1,0,48,0,-48
2287,0,0,178,0,-178
2288,0,0,77,0,-77
2289,1,0,51,0,-51
2290,1,1,85,1326,1241
2291,1,0,88,0,-88
2292,0,0,71,0,-71
2293,1,1,442,2644,2202
2294,1,0,27,0,-27
2295,1,1,607,1259,652
2296,0,0,56,0,-56
2297,1,0,32,0,-32
2298,1,1,252,2055,1803
2299,0,0,17,0,-17
2300,0,0,67,0,-67
2301,0,0,204,0,-204
2302,0,0,12,0,-12
2303,1,1,241,1221,980
2304,0,0,64,0,-64
2305,1,0,32,0,-32
2306,1,1,1109,1219,110
2307,1,1,205,2647,2442
2308,1,0,5,0,-5
2309,0,0,13,0,-13
2310,1,0,75,0,-75
2311,1,0,4,0,-4
2312,1,0,16,0,-16
2313,1,1,261,1368,1107
2314,1,0,4,0,-4
2315,1,0,4,0,-4
2316,1,1,510,1415,905
2317,0,0,111,0,-111
2318,1,0,15,0,-15
2319,1,0,299,0,-299
2320,1,0,19,0,-19
2321,1,0,15,0,-15
2322,1,0,51,0,-51
2323,1,1,1183,1630,447
2324,1,0,49,0,-49
2325,0,0,143,0,-143
2326,1,0,96,0,-96
2327,0,0,93,0,-93
2328,1,1,1559,1276,-283
2329,0,0,68,0,-68
2330,0,0,2,0,-2
2331,1,0,11,0,-11
2332,1,1,144,1397,1253
2333,0,0,45,0,-45
2334,0,0,6,0,-6
2335,1,1,1062,1229,167
2336,1,1,122,1773,1651
2337,0,0,29,0,-29
2338,1,0,6,0,-6
2339,0,0,4,0,-4
2340,1,1,39,1593,1554
2341,1,1,8,1313,1305
2342,0,0,2,0,-2
2343,0,0,22,0,-22
2344,1,1,375,1726,1351
2345,1,0,93,0,-93
2346,0,0,18,0,-18
2347,0,0,58,0,-58
2348,0,0,7,0,-7
2349,1,1,398,1371,973
2350,1,1,757,1255,498
2351,1,1,52,1369,1317
2352,0,0,27,0,-27
2353,1,0,16,0,-16
2354,1,1,663,2604,1941
2355,1,1,118,1263,1145
2356,1,0,23,0,-23
2357,0,0,39,0,-39
2358,0,0,75,0,-75
2359,1,0,11,0,-11
2360,1,0,127,0,-127
2361,0,0,9,0,-9
2362,1,1,90,1383,1293
2363,1,0,3,0,-3
2364,1,0,24,0,-24
2365,0,0,3,0,-3
2366,1,0,70,0,-70
2367,1,0,119,0,-119
2368,0,0,6,0,-6
2369,1,1,1693,1531,-162
2370,1,0,4,0,-4
2371,1,1,354,1257,903
2372,1,1,463,1282,819
2373,1,0,19,0,-19
2374,0,0,46,0,-46
2375,1,1,237,2628,2391
2376,0,0,149,0,-149
2377,1,1,1492,1318,-174
2378,1,1,184,1656,1472
2379,1,0,14,0,-14
2380,1,0,8,0,-8
2381,0,0,25,0,-25
2382,0,0,26,0,-26
2383,0,0,6,0,-6
2384,1,0,105,0,-105
2385,0,0,55,0,-55
2386,0,0,23,0,-23
2387,1,0,50,0,-50
2388,0,0,5,0,-5
2389,0,0,11,0,-11
2390,1,0,29,0,-29
2391,0,0,14,0,-14
2392,1,1,415,1471,1056
2393,0,0,18,0,-18
2394,1,0,0,0,0
2395,1,0,11,0,-11
2396,1,0,19,0,-19
2397,0,0,38,0,-38
2398,1,1,382,1271,889
2399,1,1,1054,2396,1342
2400,1,1,432,1472,1040
2401,1,1,607,1359,752
2402,0,0,26,0,-26
2403,0,0,56,0,-56
2404,1,1,190,2585,2395
2405,1,1,410,1746,1336
2406,0,0,22,0,-22
2407,1,0,65,0,-65
2408,1,1,390,1216,826
2409,1,0,54,0,-54
2410,0,0,61,0,-61
2411,1,1,360,1258,898
2412,0,0,8,0,-8
2413,1,1,561,1214,653
2414,1,0,130,0,-130
2415,1,0,79,0,-79
2416,1,1,397,1776,1379
2417,1,1,1755,1222,-533
2418,1,1,476,2068,1592
2419,1,1,762,1326,564
2420,1,0,100,0,-100
2421,0,0,2,0,-2
2422,0,0,96,0,-96
2423,0,0,8,0,-8
2424,0,0,152,0,-152
2425,1,1,62,1506,1444
2426,1,1,594,1966,1372
2427,0,0,40,0,-40
2428,1,0,8,0,-8
2429,0,0,89,0,-89
2430,1,1,245,1462,1217
2431,1,1,164,1453,1289
2432,0,0,45,0,-45
2433,0,0,85,0,-85
2434,0,0,8,0,-8
2435,1,0,3,0,-3
2436,1,0,4,0,-4
2437,1,1,749,1380,631
2438,1,1,105,1301,1196
2439,1,1,53,1393,1340
2440,0,0,4,0,-4
2441,1,1,480,1281,801
2442,0,0,40,0,-40
2443,1,0,85,0,-85
2444,0,0,36,0,-36
2445,0,0,39,0,-39
2446,1,1,1592,1254,-338
2447,1,0,17,0,-17
2448,1,1,354,1220,866
2449,0,0,28,0,-28
2450,0,0,6,0,-6
2451,0,0,25,0,-25
2452,0,0,9,0,-9
2453,1,1,39,1244,1205
2454,1,0,70,0,-70
2455,0,0,15,0,-15
2456,0,0,141,0,-141
2457,1,0,16,0,-16
2458,0,0,9,0,-9
2459,1,0,45,0,-45
2460,1,1,363,1271,908
2461,1,1,380,1450,1070
2462,1,1,1073,1698,625
2463,1,1,1279,1301,22
2464,1,1,452,1398,946
2465,0,0,16,0,-16
2466,1,1,470,1520,1050
2467,1,0,138,0,-138
2468,1,1,1643,1266,-377
2469,0,0,82,0,-82
2470,1,0,69,0,-69
2471,1,0,9,0,-9
2472,1,0,12,0,-12
2473,0,0,34,0,-34
2474,0,0,4,0,-4
2475,1,0,9,0,-9
2476,0,0,56,0,-56
2477,0,0,185,0,-185
2478,1,0,182,0,-182
2479,1,0,59,0,-59
2480,1,0,32,0,-32
2481,1,0,156,0,-156
2482,0,0,17,0,-17
2483,0,0,134,0,-134
2484,1,1,874,1317,443
2485,1,0,74,0,-74
2486,1,1,97,1237,1140
2487,1,1,862,1680,818
2488,1,1,748,1456,708
2489,1,1,177,1327,1150
2490,0,0,10,0,-10
2491,1,0,39,0,-39
2492,0,0,0,0,0
2493,0,0,5,0,-5
2494,1,0,21,0,-21
2495,1,1,455,1310,855
2496,1,1,253,1362,1109
2497,1,1,515,2129,1614
2498,1,0,12,0,-12
2499,1,1,351,1336,985
2500,0,0,4,0,-4
2501,1,1,700,1436,736
2502,0,0,65,0,-65
2503,1,1,599,1635,1036
2504,0,0,8,0,-8
2505,0,0,89,0,-89
2506,0,0,17,0,-17
2507,0,0,30,0,-30
2508,0,0,21,0,-21
2509,1,1,1009,1318,309
2510,1,1,648,1761,1113
2511,0,0,44,0,-44
2512,0,0,49,0,-49
2513,0,0,116,0,-116
2514,1,0,29,0,-29
2515,0,0,66,0,-66
2516,1,0,326,0,-326
2517,1,0,40,0,-40
2518,1,1,221,1275,1054
2519,1,1,585,1388,803
2520,1,1,541,1473,932
2521,0,0,100,0,-100
2522,0,0,5,0,-5
2523,0,0,15,0,-15
2524,1,0,111,0,-111
2525,1,1,365,1748,1383
2526,1,1,455,1320,865
2527,1,1,808,1374,566
2528,0,0,122,0,-122
2529,1,1,346,1241,895
2530,0,0,22,0,-22
2531,1,1,665,1231,566
2532,0,0,5,0,-5
2533,0,0,192,0,-192
2534,1,1,46,1935,1889
2535,1,0,104,0,-104
2536,1,0,2,0,-2
2537,1,0,188,0,-188
2538,1,0,195,0,-195
2539,0,0,10,0,-10
2540,0,0,3,0,-3
2541,1,1,1402,1266,-136
2542,1,1,373,1333,960
2543,0,0,112,0,-112
2544,1,0,37,0,-37
2545,1,0,29,0,-29
2546,0,0,40,0,-40
2547,1,1,163,1256,1093
2548,1,1,1153,1758,605
2549,1,0,7,0,-7
2550,1,1,631,1537,906
2551,1,1,126,1259,1133
2552,1,1,215,1778,1563
2553,1,1,1188,1422,234
2554,0,0,9,0,-9
2555,1,1,498,1435,937
2556,0,0,78,0,-78
2557,1,0,116,0,-116
2558,1,1,55,1580,1525
2559,0,0,66,0,-66
2560,0,0,34,0,-34
2561,0,0,81,0,-81
2562,1,1,1465,1514,49
2563,0,0,14,0,-14
2564,1,0,3,0,-3
2565,1,0,20,0,-20
2566,0,0,48,0,-48
2567,0,0,35,0,-35
2568,1,0,68,0,-68
2569,0,0,195,0,-195
2570,0,0,21,0,-21
2571,1,1,432,1274,842
2572,1,1,173,1512,1339
2573,1,0,43,0,-43
2574,0,0,62,0,-62
2575,0,0,25,0,-25
2576,1,0,3,0,-3
2577,1,0,18,0,-18
2578,0,0,16,0,-16
2579,1,0,25,0,-25
2580,0,0,51,0,-51
2581,1,1,119,1394,1275
2582,1,1,156,1236,1080
2583,1,1,112,1290,1178
2584,1,1,82,1452,1370
2585,1,0,20,0,-20
2586,0,0,61,0,-61
2587,1,0,12,0,-12
2588,1,1,476,1703,1227
2589,0,0,16,0,-16
2590,1,1,232,1234,1002
2591,1,0,89,0,-89
2592,0,0,8,0,-8
2593,1,1,286,1281,995
2594,0,0,0,0,0
2595,1,0,77,0,-77
2596,1,0,35,0,-35
2597,0,0,117,0,-117
2598,0,0,20,0,-20
2599,0,0,107,0,-107
2600,1,0,109,0,-109
2601,0,0,32,0,-32
2602,0,0,155,0,-155
2603,1,0,33,0,-33
2604,0,0,10,0,-10
2605,0,0,20,0,-20
2606,0,0,15,0,-15
2607,0,0,2,0,-2
2608,1,1,370,1266,896
2609,0,0,36,0,-36
2610,0,0,61,0,-61
2611,1,1,940,1357,417
2612,0,0,34,0,-34
2613,1,0,15,0,-15
2614,1,1,64,1501,1437
2615,1,0,24,0,-24
2616,0,0,9,0,-9
2617,1,0,44,0,-44
2618,0,0,74,0,-74
2619,0,0,110,0,-110
2620,0,0,3,0,-3
2621,0,0,27,0,-27
2622,1,1,215,1201,986
2623,1,0,10,0,-10
2624,1,1,299,1616,1317
2625,0,0,108,0,-108
2626,1,0,41,0,-41
2627,0,0,42,0,-42
2628,1,1,805,1491,686
2629,1,1,706,1436,730
2630,1,1,671,1254,583
2631,0,0,63,0,-63
2632,1,0,21,0,-21
2633,1,1,1290,1247,-43
2634,1,0,64,0,-64
2635,1,1,747,1275,528
2636,1,1,354,1438,1084
2637,0,0,102,0,-102
2638,0,0,40,0,-40
2639,1,1,1035,1287,252
2640,1,1,579,1346,767
2641,0,0,19,0,-19
2642,1,0,18,0,-18
2643,0,0,38,0,-38
2644,1,0,34,0,-34
2645,1,1,385,1258,873
2646,1,1,124,5100,4976
2647,0,0,0,0,0
2648,0,0,53,0,-53
2649,1,1,130,1387,1257
2650,0,0,171,0,-171
2651,1,1,553,1314,761
2652,1,1,65,2443,2378
2653,0,0,148,0,-148
2654,1,0,62,0,-62
2655,0,0,52,0,-52
2656,0,0,24,0,-24
2657,1,0,59,0,-59
2658,0,0,105,0,-105
2659,0,0,3,0,-3
2660,1,1,49,1521,1472
2661,1,1,323,1282,959
2662,1,1,176,2236,2060
2663,1,0,37,0,-37
2664,1,0,22,0,-22
2665,1,1,195,1428,1233
2666,0,0,13,0,-13
2667,1,1,223,1776,1553
2668,1,0,32,0,-32
2669,1,0,60,0,-60
2670,0,0,30,0,-30
2671,1,0,27,0,-27
2672,1,1,496,1200,704
2673,1,0,3,0,-3
2674,1,1,225,1726,1501
2675,0,0,9,0,-9
2676,0,0,45,0,-45
2677,0,0,38,0,-38
2678,1,0,89,0,-89
2679,1,0,65,0,-65
2680,1,0,61,0,-61
2681,1,1,609,1232,623
2682,1,0,103,0,-103
2683,1,0,69,0,-69
2684,1,1,666,1517,851
2685,1,0,15,0,-15
2686,1,0,11,0,-11
2687,0,0,24,0,-24
2688,1,1,932,1358,426
2689,1,1,2507,1471,-1036
2690,0,0,24,0,-24
2691,1,1,207,1411,1204
2692,1,1,166,1331,1165
2693,1,1,595,1490,895
2694,1,1,50,1256,1206
2695,1,0,42,0,-42
2696,0,0,24,0,-24
2697,1,0,3,0,-3
2698,0,0,29,0,-29
2699,0,0,33,0,-33
2700,1,1,359,1317,958
2701,1,0,2,0,-2
2702,1,0,5,0,-5
2703,1,0,29,0,-29
2704,0,0,203,0,-203
2705,0,0,8,0,-8
2706,1,0,50,0,-50
2707,1,1,487,1470,983
2708,1,1,165,1279,1114
2709,0,0,2,0,-2
2710,0,0,11,0,-11
2711,0,0,58,0,-58
2712,1,0,82,0,-82
2713,1,0,111,0,-111
2714,1,0,37,0,-37
2715,1,0,70,0,-70
2716,1,0,1,0,-1
2717,0,0,43,0,-43
2718,1,0,50,0,-50
2719,0,0,14,0,-14
2720,0,0,21,0,-21
2721,0,0,12,0,-12
2722,1,1,777,1539,762
2723,1,1,167,1536,1369
2724,0,0,23,0,-23
2725,0,0,51,0,-51
2726,0,0,79,0,-79
2727,0,0,25,0,-25
2728,1,1,136,1277,1141
2729,1,0,4,0,-4
2730,1,0,8,0,-8
2731,0,0,3,0,-3
2732,1,1,802,1273,471
2733,1,0,215,0,-215
2734,1,0,12,0,-12
2735,1,0,115,0,-115
2736,0,0,33,0,-33
2737,1,1,462,1297,835
2738,1,0,83,0,-83
2739,0,0,15,0,-15
2740,1,0,119,0,-119
2741,1,0,12,0,-12
2742,1,1,952,1379,427
2743,0,0,5,0,-5
2744,0,0,17,0,-17
2745,1,0,111,0,-111
2746,1,0,31,0,-31
2747,1,0,46,0,-46
2748,0,0,124,0,-124
2749,1,0,90,0,-90
2750,0,0,10,0,-10
2751,0,0,101,0,-101
2752,1,0,36,0,-36
2753,0,0,13,0,-13
2754,1,1,556,1448,892
2755,1,0,150,0,-150
2756,1,1,1168,1344,176
2757,1,0,53,0,-53
2758,1,0,27,0,-27
2759,1,1,89,1537,1448
2760,1,0,64,0,-64
2761,1,1,1406,1211,-195
2762,1,0,38,0,-38
2763,1,1,2327,1444,-883
2764,1,1,24,1362,1338
2765,1,1,73,1504,1431
2766,0,0,32,0,-32
2767,0,0,33,0,-33
2768,1,0,38,0,-38
2769,1,1,250,1750,1500
2770,1,0,172,0,-172
2771,1,0,114,0,-114
2772,1,0,39,0,-39
2773,0,0,20,0,-20
2774,1,0,92,0,-92
2775,0,0,77,0,-77
2776,1,0,33,0,-33
2777,1,1,612,1546,934
2778,0,0,21,0,-21
2779,0,0,16,0,-16
2780,0,0,69,0,-69
2781,1,0,25,0,-25
2782,0,0,8,0,-8
2783,1,1,212,1329,1117
2784,0,0,3,0,-3
2785,0,0,35,0,-35
2786,1,1,221,2283,2062
2787,1,1,307,1239,932
2788,1,0,9,0,-9
2789,1,0,83,0,-83
2790,0,0,0,0,0
2791,0,0,70,0,-70
2792,1,0,19,0,-19
2793,1,0,27,0,-27
2794,1,0,4,0,-4
2795,0,0,34,0,-34
2796,1,0,57,0,-57
2797,1,1,115,1736,1621
2798,0,0,45,0,-45
2799,1,0,49,0,-49
2800,1,1,306,1281,975
2801,0,0,10,0,-10
2802,0,0,15,0,-15
2803,1,0,29,0,-29
2804,0,0,19,0,-19
2805,1,1,551,1714,1163
2806,1,0,79,0,-79
2807,1,1,314,2186,1872
2808,1,1,590,1302,712
2809,1,0,2,0,-2
2810,1,1,785,1384,599
2811,1,1,6,1998,1992
2812,1,0,3,0,-3
2813,1,1,103,1623,1520
2814,1,1,562,1308,746
2815,0,0,46,0,-46
2816,0,0,46,0,-46
2817,0,0,177,0,-177
2818,1,1,270,2242,1972
2819,1,1,554,1264,710
2820,1,0,56,0,-56
2821,1,0,21,0,-21
2822,1,0,17,0,-17
2823,0,0,68,0,-68
2824,0,0,22,0,-22
2825,1,0,284,0,-284
2826,1,1,1725,1589,-136
2827,0,0,331,0,-331
2828,1,1,557,1287,730
2829,0,0,9,0,-9
2830,1,1,260,1299,1039
2831,1,1,52,1535,1483
2832,0,0,5,0,-5
2833,0,0,17,0,-17
2834,1,0,23,0,-23
2835,1,0,44,0,-44
2836,0,0,1,0,-1
2837,1,1,324,1633,1309
2838,1,1,435,1236,801
2839,0,0,7,0,-7
2840,1,0,43,0,-43
2841,0,0,50,0,-50
2842,1,1,1470,1441,-29
2843,1,1,1022,1207,185
2844,1,0,10,0,-10
2845,0,0,36,0,-36
2846,0,0,67,0,-67
2847,1,0,28,0,-28
2848,1,0,51,0,-51
2849,1,0,34,0,-34
2850,1,1,131,2866,2735
2851,0,0,29,0,-29
2852,0,0,168,0,-168
2853,0,0,33,0,-33
2854,1,1,1113,2006,893
2855,0,0,74,0,-74
2856,0,0,178,0,-178
2857,0,0,22,0,-22
2858,1,0,84,0,-84
2859,1,1,11,1806,1795
2860,0,0,50,0,-50
2861,1,0,85,0,-85
2862,0,0,17,0,-17
2863,1,0,16,0,-16
2864,0,0,42,0,-42
2865,1,1,196,1441,1245
2866,1,0,24,0,-24
2867,1,1,1363,1221,-142
2868,0,0,102,0,-102
2869,1,1,61,1522,1461
2870,1,1,649,1254,605
2871,1,1,224,1614,1390
2872,1,1,46,1949,1903
2873,0,0,58,0,-58
2874,1,0,7,0,-7
2875,1,1,91,1322,1231
2876,1,1,836,2350,1514
2877,1,1,1515,1441,-74
2878,1,1,781,1220,439
2879,1,1,273,2219,1946
2880,1,0,128,0,-128
2881,1,0,13,0,-13
2882,0,0,55,0,-55
2883,1,1,1200,1461,261
2884,1,1,702,1476,774
2885,0,0,76,0,-76
2886,0,0,22,0,-22
2887,0,0,104,0,-104
2888,0,0,131,0,-131
2889,0,0,64,0,-64
2890,0,0,26,0,-26
2891,1,1,74,1605,1531
2892,1,0,42,0,-42
2893,1,1,306,1316,1010
2894,1,1,575,1586,1011
2895,1,0,138,0,-138
2896,0,0,69,0,-69
2897,1,1,42,1259,1217
2898,1,1,317,1462,1145
2899,1,1,89,2792,2703
2900,1,1,295,1597,1302
2901,0,0,6,0,-6
2902,1,1,351,1315,964
2903,0,0,225,0,-225
2904,1,0,37,0,-37
2905,1,1,196,1208,1012
2906,1,1,658,1254,596
2907,1,1,1074,1679,605
2908,0,0,3,0,-3
2909,1,0,17,0,-17
2910,0,0,34,0,-34
2911,0,0,66,0,-66
2912,1,1,697,1233,536
2913,1,0,15,0,-15
2914,1,1,370,1403,1033
2915,0,0,29,0,-29
2916,0,0,32,0,-32
2917,1,0,7,0,-7
2918,1,0,37,0,-37
2919,0,0,107,0,-107
2920,0,0,23,0,-23
2921,1,1,630,1574,944
2922,1,0,4,0,-4
2923,1,1,196,1988,1792
2924,1,1,78,1291,1213
2925,1,1,973,1574,601
2926,1,1,215,1379,1164
2927,1,0,34,0,-34
2928,1,1,33,1489,1456
2929,1,0,12,0,-12
2930,1,0,50,0,-50
2931,1,1,690,1520,830
2932,1,1,168,1498,1330
2933,0,0,94,0,-94
2934,0,0,79,0,-79
2935,1,1,287,1297,1010
2936,1,0,21,0,-21
2937,0,0,120,0,-120
2938,1,1,276,1780,1504
2939,0,0,0,0,0
2940,0,0,60,0,-60
2941,1,1,1453,1225,-228
2942,1,0,29,0,-29
2943,1,0,8,0,-8
2944,1,1,736,1241,505
2945,1,1,1312,1273,-39
2946,1,0,21,0,-21
2947,1,0,42,0,-42
2948,1,1,324,2246,1922
2949,0,0,0,0,0
2950,0,0,11,0,-11
2951,1,0,28,0,-28
2952,1,0,32,0,-32
2953,1,0,33,0,-33
2954,1,0,1,0,-1
2955,1,1,1161,1579,418
2956,0,0,37,0,-37
2957,0,0,35,0,-35
2958,1,1,198,1363,1165
2959,1,0,143,0,-143
2960,0,0,112,0,-112
2961,0,0,176,0,-176
2962,1,1,1103,1345,242
2963,1,1,821,1225,404
2964,1,0,19,0,-19
2965,0,0,13,0,-13
2966,0,0,2,0,-2
2967,0,0,13,0,-13
2968,1,0,10,0,-10
2969,0,0,12,0,-12
2970,1,0,182,0,-182
2971,0,0,12,0,-12
2972,1,0,132,0,-132
2973,1,1,274,2176,1902
2974,1,0,21,0,-21
2975,0,0,6,0,-6
2976,1,0,122,0,-122
2977,0,0,16,0,-16
2978,1,0,51,0,-51
2979,0,0,15,0,-15
2980,1,0,128,0,-128
2981,1,1,316,1217,901
2982,1,0,48,0,-48
2983,0,0,31,0,-31
2984,1,0,34,0,-34
2985,0,0,41,0,-41
2986,0,0,2,0,-2
2987,1,0,8,0,-8
2988,1,0,22,0,-22
2989,1,0,7,0,-7
2990,1,1,64,1867,1803
2991,1,1,149,2237,2088
2992,1,1,732,1350,618
2993,1,1,581,1659,1078
2994,0,0,87,0,-87
2995,0,0,4,0,-4
2996,0,0,15,0,-15
2997,1,1,160,1486,1326
2998,0,0,17,0,-17
2999,0,0,5,0,-5
3000,1,1,877,1232,355
3001,1,1,1738,1305,-433
3002,0,0,9,0,-9
3003,0,0,15,0,-15
3004,1,1,609,1486,877
3005,0,0,242,0,-242
3006,0,0,31,0,-31
3007,1,0,21,0,-21
3008,1,1,34,1231,1197
3009,1,0,66,0,-66
3010,0,0,81,0,-81
3011,0,0,57,0,-57
3012,0,0,26,0,-26
3013,0,0,22,0,-22
3014,0,0,0,0,0
3015,1,0,63,0,-63
3016,1,1,1355,1380,25
3017,0,0,48,0,-48
3018,1,1,426,1336,910
3019,1,0,60,0,-60
3020,1,1,833,1290,457
3021,0,0,100,0,-100
3022,1,1,448,1261,813
3023,0,0,103,0,-103
3024,1,1,805,1271,466
3025,0,0,17,0,-17
3026,1,0,30,0,-30
3027,0,0,45,0,-45
3028,0,0,7,0,-7
3029,0,0,62,0,-62
3030,0,0,130,0,-130
3031,1,1,839,1259,420
3032,1,1,464,2525,2061
3033,0,0,27,0,-27
3034,1,1,795,1393,598
3035,0,0,16,0,-16
3036,0,0,105,0,-105
3037,1,1,531,1230,699
3038,1,0,25,0,-25
3039,0,0,34,0,-34
3040,1,1,455,1866,1411
3041,0,0,78,0,-78
3042,1,1,487,1328,841
3043,1,0,1,0,-1
3044,1,1,378,1441,1063
3045,0,0,11,0,-11
3046,1,0,7,0,-7
3047,0,0,35,0,-35
3048,1,0,13,0,-13
3049,1,1,853,2094,1241
3050,0,0,50,0,-50
3051,0,0,1,0,-1
3052,1,0,44,0,-44
3053,1,1,345,1366,1021
3054,1,1,1482,1348,-134
3055,1,0,6,0,-6
3056,0,0,13,0,-13
3057,0,0,51,0,-51
3058,0,0,55,0,-55
3059,0,0,0,0,0
3060,1,1,172,1771,1599
3061,1,0,95,0,-95
3062,0,0,19,0,-19
3063,1,0,1,0,-1
3064,1,1,149,1306,1157
3065,1,1,165,1315,1150
3066,1,0,11,0,-11
3067,1,0,24,0,-24
3068,1,0,27,0,-27
3069,0,0,17,0,-17
3070,0,0,36,0,-36
3071,1,1,154,1237,1083
3072,1,0,162,0,-162
3073,0,0,31,0,-31
3074,0,0,64,0,-64
3075,0,0,6,0,-6
3076,1,1,1241,1461,220
3077,0,0,182,0,-182
3078,0,0,92,0,-92
3079,1,0,35,0,-35
3080,1,1,162,1213,1051
3081,0,0,5,0,-5
3082,1,0,6,0,-6
3083,0,0,189,0,-189
3084,1,1,600,1241,641
3085,1,1,290,1552,1262
3086,1,1,338,1616,1278
3087,0,0,54,0,-54
3088,1,1,357,1200,843
3089,1,0,35,0,-35
3090,0,0,72,0,-72
3091,0,0,46,0,-46
3092,1,1,136,1968,1832
3093,0,0,33,0,-33
3094,0,0,3,0,-3
3095,1,0,13,0,-13
3096,1,0,37,0,-37
3097,1,1,162,1208,1046
3098,1,1,159,1388,1229
3099,0,0,11,0,-11
3100,1,0,12,0,-12
3101,1,0,75,0,-75
3102,1,0,14,0,-14
3103,0,0,7,0,-7
3104,1,1,456,1451,995
3105,1,0,22,0,-22
3106,1,1,176,1444,1268
3107,1,0,9,0,-9
3108,0,0,143,0,-143
3109,1,1,541,1739,1198
3110,0,0,133,0,-133
3111,0,0,97,0,-97
3112,1,1,146,2398,2252
3113,0,0,14,0,-14
3114,0,0,207,0,-207
3115,1,1,962,1521,559
3116,1,0,57,0,-57
3117,1,1,677,1320,643
3118,0,0,8,0,-8
3119,0,0,77,0,-77
3120,0,0,41,0,-41
3121,1,0,30,0,-30
3122,1,0,2,0,-2
3123,1,0,16,0,-16
3124,1,1,1200,1207,7
3125,0,0,64,0,-64
3126,1,0,81,0,-81
3127,1,1,1007,1380,373
3128,1,1,131,1228,1097
3129,1,0,10,0,-10
3130,0,0,220,0,-220
3131,0,0,164,0,-164
3132,1,0,55,0,-55
3133,1,1,187,2142,1955
3134,1,1,493,1315,822
3135,0,0,49,0,-49
3136,1,0,16,0,-16
3137,1,0,27,0,-27
3138,0,0,103,0,-103
3139,0,0,146,0,-146
3140,0,0,22,0,-22
3141,1,0,118,0,-118
3142,1,1,59,1629,1570
3143,0,0,62,0,-62
3144,1,0,39,0,-39
3145,0,0,35,0,-35
3146,0,0,133,0,-133
3147,0,0,55,0,-55
3148,1,0,66,0,-66
3149,0,0,47,0,-47
3150,1,0,33,0,-33
3151,0,0,4,0,-4
3152,0,0,21,0,-21
3153,1,0,4,0,-4
3154,0,0,4,0,-4
3155,0,0,1,0,-1
3156,0,0,9,0,-9
3157,0,0,11,0,-11
3158,0,0,94,0,-94
3159,1,0,10,0,-10
3160,1,1,597,1328,731
3161,0,0,60,0,-60
3162,0,0,61,0,-61
3163,1,0,10,0,-10
3164,0,0,240,0,-240
3165,0,0,15,0,-15
3166,1,0,172,0,-172
3167,1,0,16,0,-16
3168,1,1,852,1405,553
3169,0,0,54,0,-54
3170,0,0,95,0,-95
3171,1,1,106,1298,1192
3172,0,0,109,0,-109
3173,0,0,44,0,-44
3174,1,1,872,2490,1618
3175,0,0,60,0,-60
3176,1,1,512,1321,809
3177,1,0,172,0,-172
3178,1,1,977,1585,608
3179,0,0,9,0,-9
3180,1,1,764,1913,1149
3181,1,1,286,1248,962
3182,0,0,29,0,-29
3183,0,0,8,0,-8
3184,1,0,17,0,-17
3185,0,0,22,0,-22
3186,0,0,45,0,-45
3187,1,0,31,0,-31
3188,1,0,43,0,-43
3189,0,0,146,0,-146
3190,1,0,187,0,-187
3191,0,0,33,0,-33
3192,1,1,616,1489,873
3193,1,0,35,0,-35
3194,1,1,152,1376,1224
3195,1,0,83,0,-83
3196,1,1,12,1203,1191
3197,0,0,175,0,-175
3198,1,0,50,0,-50
3199,1,1,179,1645,1466
3200,0,0,22,0,-22
3201,1,0,68,0,-68
3202,1,0,78,0,-78
3203,1,1,937,1695,758
3204,1,0,42,0,-42
3205,1,0,73,0,-73
3206,0,0,147,0,-147
3207,0,0,147,0,-147
3208,1,0,52,0,-52
3209,1,1,1224,1331,107
3210,1,0,27,0,-27
3211,0,0,27,0,-27
3212,1,0,19,0,-19
3213,0,0,58,0,-58
3214,1,0,12,0,-12
3215,1,1,927,1388,461
3216,0,0,116,0,-116
3217,1,0,40,0,-40
3218,1,1,2133,1633,-500
3219,0,0,102,0,-102
3220,1,0,24,0,-24
3221,1,1,410,1333,923
3222,0,0,111,0,-111
3223,1,0,35,0,-35
3224,0,0,42,0,-42
3225,1,1,331,1470,1139
3226,1,1,270,1256,986
3227,1,1,814,1708,894
3228,1,1,623,1283,660
3229,0,0,31,0,-31
3230,1,1,811,1217,406
3231,1,0,84,0,-84
3232,1,0,38,0,-38
3233,0,0,45,0,-45
3234,1,1,476,1345,869
3235,1,1,178,1527,1349
3236,1,0,43,0,-43
3237,1,1,1366,1593,227
3238,1,0,23,0,-23
3239,1,0,13,0,-13
3240,1,0,78,0,-78
3241,0,0,18,0,-18
3242,1,0,68,0,-68
3243,0,0,16,0,-16
3244,1,1,51,1737,1686
3245,0,0,2,0,-2
3246,0,0,60,0,-60
3247,1,1,62,1399,1337
3248,1,0,14,0,-14
3249,1,1,52,1238,1186
3250,1,1,657,1233,576
3251,1,0,1,0,-1
3252,0,0,4,0,-4
3253,1,1,260,1812,1552
3254,1,0,65,0,-65
3255,1,1,475,1213,738
3256,1,1,40,1346,1306
3257,0,0,26,0,-26
3258,1,1,671,1934,1263
3259,0,0,71,0,-71
3260,1,1,621,2229,1608
3261,1,1,84,1409,1325
3262,1,1,576,1210,634
3263,0,0,5,0,-5
3264,0,0,13,0,-13
3265,1,0,37,0,-37
3266,1,0,46,0,-46
3267,0,0,109,0,-109
3268,0,0,143,0,-143
3269,1,1,661,1354,693
3270,1,0,31,0,-31
3271,0,0,106,0,-106
3272,1,0,108,0,-108
3273,0,0,118,0,-118
3274,0,0,52,0,-52
3275,0,0,17,0,-17
3276,1,0,88,0,-88
3277,0,0,36,0,-36
3278,1,0,68,0,-68
3279,1,0,108,0,-108
3280,0,0,100,0,-100
3281,0,0,31,0,-31
3282,1,0,58,0,-58
3283,1,0,42,0,-42
3284,1,0,1,0,-1
3285,1,0,4,0,-4
3286,1,0,22,0,-22
3287,1,1,205,1255,1050
3288,1,0,58,0,-58
3289,1,0,74,0,-74
3290,1,0,55,0,-55
3291,0,0,249,0,-249
3292,1,1,245,1543,1298
3293,1,0,239,0,-239
3294,0,0,22,0,-22
3295,1,0,71,0,-71
3296,0,0,29,0,-29
3297,1,1,3399,2441,-958
3298,1,1,485,1673,1188
3299,1,1,1394,1462,68
3300,0,0,1,0,-1
3301,0,0,3,0,-3
3302,0,0,13,0,-13
3303,1,0,4,0,-4
3304,1,0,48,0,-48
3305,1,0,38,0,-38
3306,1,0,57,0,-57
3307,1,1,379,2088,1709
3308,1,0,89,0,-89
3309,1,1,204,1385,1181
3310,1,1,411,1330,919
3311,0,0,258,0,-258
3312,0,0,9,0,-9
3313,0,0,6,0,-6
3314,0,0,24,0,-24
3315,1,0,3,0,-3
3316,0,0,112,0,-112
3317,0,0,35,0,-35
3318,0,0,34,0,-34
3319,1,1,603,2997,2394
3320,0,0,15,0,-15
3321,0,0,56,0,-56
3322,1,1,394,2492,2098
3323,0,0,1,0,-1
3324,0,0,148,0,-148
3325,0,0,78,0,-78
3326,1,1,53,1404,1351
3327,0,0,8,0,-8
3328,1,0,30,0,-30
3329,1,0,21,0,-21
3330,0,0,12,0,-12
3331,1,1,42,2191,2149
3332,0,0,53,0,-53
3333,0,0,41,0,-41
3334,0,0,77,0,-77
3335,1,1,804,1379,575
3336,1,1,694,1261,567
3337,1,1,1691,1331,-360
3338,1,0,123,0,-123
3339,1,0,19,0,-19
3340,1,1,1653,3862,2209
3341,1,1,109,1881,1772
3342,1,0,95,0,-95
3343,1,1,58,1362,1304
3344,1,0,30,0,-30
3345,1,1,153,1549,1396
3346,1,1,612,1696,1084
3347,0,0,8,0,-8
3348,1,1,363,1250,887
3349,1,1,156,1963,1807
3350,1,1,413,4323,3910
3351,0,0,44,0,-44
3352,1,0,7,0,-7
3353,1,1,41,1251,1210
3354,0,0,35,0,-35
3355,1,1,540,1259,719
3356,1,1,492,1857,1365
3357,1,0,14,0,-14
3358,1,0,39,0,-39
3359,0,0,14,0,-14
3360,1,0,119,0,-119
3361,1,0,13,0,-13
3362,1,1,655,2085,1430
3363,0,0,140,0,-140
3364,1,0,74,0,-74
3365,1,0,6,0,-6
3366,0,0,9,0,-9
3367,1,0,132,0,-132
3368,1,0,56,0,-56
3369,0,0,9,0,-9
3370,1,0,0,0,0
3371,0,0,32,0,-32
3372,0,0,9,0,-9
3373,1,1,1353,1304,-49
3374,1,1,197,1427,1230
3375,1,1,296,1222,926
3376,1,0,26,0,-26
3377,1,1,118,1240,1122
3378,1,0,54,0,-54
3379,1,1,283,1563,1280
3380,1,0,84,0,-84
3381,1,0,57,0,-57
3382,0,0,94,0,-94
3383,0,0,53,0,-53
3384,0,0,49,0,-49
3385,0,0,16,0,-16
3386,0,0,33,0,-33
3387,0,0,124,0,-124
3388,1,1,588,1662,1074
3389,1,0,23,0,-23
3390,1,1,608,2948,2340
3391,1,1,1108,1347,239
3392,0,0,102,0,-102
3393,1,0,27,0,-27
3394,1,1,1369,1302,-67
3395,1,1,168,1660,1492
3396,0,0,35,0,-35
3397,0,0,19,0,-19
3398,1,0,13,0,-13
3399,1,1,763,1736,973
3400,0,0,60,0,-60
3401,0,0,10,0,-10
3402,0,0,23,0,-23
3403,1,0,21,0,-21
3404,1,1,591,1956,1365
3405,1,1,351,1242,891
3406,1,1,104,1386,1282
3407,0,0,39,0,-39
3408,0,0,72,0,-72
3409,1,1,240,1904,1664
3410,0,0,39,0,-39
3411,1,0,190,0,-190
3412,0,0,249,0,-249
3413,1,0,7,0,-7
3414,0,0,27,0,-27
3415,0,0,20,0,-20
3416,1,0,193,0,-193
3417,0,0,14,0,-14
3418,1,0,44,0,-44
3419,0,0,35,0,-35
3420,1,0,63,0,-63
3421,1,0,40,0,-40
3422,0,0,151,0,-151
3423,0,0,40,0,-40
3424,0,0,53,0,-53
3425,1,1,239,1799,1560
3426,1,1,885,1262,377
3427,1,0,9,0,-9
3428,1,0,16,0,-16
3429,1,0,65,0,-65
3430,0,0,39,0,-39
3431,1,1,750,1368,618
3432,1,0,0,0,0
3433,1,1,1400,1589,189
3434,1,0,3,0,-3
3435,1,1,3088,1796,-1292
3436,1,1,998,1259,261
3437,1,0,3,0,-3
3438,0,0,81,0,-81
3439,0,0,8,0,-8
3440,1,0,11,0,-11
3441,1,0,13,0,-13
3442,0,0,89,0,-89
3443,0,0,22,0,-22
3444,0,0,15,0,-15
3445,1,1,105,1913,1808
3446,1,1,135,1294,1159
3447,0,0,26,0,-26
3448,1,1,1204,2128,924
3449,1,1,90,1403,1313
3450,0,0,26,0,-26
3451,0,0,30,0,-30
3452,1,0,36,0,-36
3453,1,0,62,0,-62
3454,0,0,32,0,-32
3455,0,0,40,0,-40
3456,1,1,145,1393,1248
3457,0,0,14,0,-14
3458,0,0,9,0,-9
3459,1,0,55,0,-55
3460,1,0,26,0,-26
3461,1,1,721,1356,635
3462,1,1,655,1321,666
3463,1,1,109,1567,1458
3464,0,0,107,0,-107
3465,0,0,0,0,0
3466,0,0,194,0,-194
3467,0,0,100,0,-100
3468,1,0,36,0,-36
3469,0,0,176,0,-176
3470,1,1,16,1704,1688
3471,1,0,66,0,-66
3472,0,0,71,0,-71
3473,0,0,225,0,-225
3474,0,0,14,0,-14
3475,1,1,2593,1245,-1348
3476,0,0,30,0,-30
3477,1,0,181,0,-181
3478,0,0,17,0,-17
3479,1,0,2,0,-2
3480,0,0,14,0,-14
3481,1,0,27,0,-27
3482,1,0,61,0,-61
3483,1,1,163,1806,1643
3484,0,0,12,0,-12
3485,0,0,83,0,-83
3486,0,0,43,0,-43
3487,0,0,26,0,-26
3488,1,0,108,0,-108
3489,0,0,23,0,-23
3490,1,0,7,0,-7
3491,1,1,628,1518,890
3492,1,1,2603,1261,-1342
3493,1,0,13,0,-13
3494,1,1,1183,2417,1234
3495,1,0,67,0,-67
3496,0,0,25,0,-25
3497,0,0,14,0,-14
3498,0,0,160,0,-160
3499,1,0,53,0,-53
3500,1,0,38,0,-38
3501,1,1,410,1241,831
3502,1,0,71,0,-71
3503,1,1,363,2638,2275
3504,0,0,56,0,-56
3505,1,1,172,1234,1062
3506,1,1,544,1402,858
3507,0,0,85,0,-85
3508,1,0,10,0,-10
3509,1,1,300,1408,1108
3510,0,0,4,0,-4
3511,0,0,14,0,-14
3512,1,1,273,1352,1079
3513,0,0,111,0,-111
3514,0,0,20,0,-20
3515,1,1,393,1218,825
3516,1,1,611,1909,1298
3517,0,0,38,0,-38
3518,1,0,57,0,-57
3519,1,1,1876,1348,-528
3520,1,1,666,2184,1518
3521,1,1,498,1548,1050
3522,1,1,1378,1451,73
3523,1,0,52,0,-52
3524,0,0,21,0,-21
3525,1,0,100,0,-100
3526,0,0,57,0,-57
3527,1,1,372,1289,917
3528,1,1,2388,2131,-257
3529,1,0,107,0,-107
3530,1,0,38,0,-38
3531,0,0,2,0,-2
3532,0,0,21,0,-21
3533,1,0,83,0,-83
3534,1,1,233,1611,1378
3535,0,0,14,0,-14
3536,0,0,49,0,-49
3537,0,0,14,0,-14
3538,0,0,22,0,-22
3539,1,1,58,1243,1185
3540,1,1,147,1288,1141
3541,1,1,795,1456,661
3542,1,1,126,1401,1275
3543,1,0,146,0,-146
3544,1,1,722,1340,618
3545,1,1,120,1472,1352
3546,0,0,59,0,-59
3547,0,0,100,0,-100
3548,1,0,109,0,-109
3549,1,1,209,1631,1422
3550,1,1,81,1453,1372
3551,1,1,868,1248,380
3552,1,0,45,0,-45
3553,0,0,30,0,-30
3554,1,0,18,0,-18
3555,1,0,6,0,-6
3556,0,0,59,0,-59
3557,1,1,1120,2134,1014
3558,1,0,251,0,-251
3559,1,0,54,0,-54
3560,1,1,64,1945,1881
3561,1,0,6,0,-6
3562,1,1,78,1287,1209
3563,1,1,452,1732,1280
3564,0,0,199,0,-199
3565,1,0,43,0,-43
3566,0,0,13,0,-13
3567,0,0,55,0,-55
3568,0,0,5,0,-5
3569,0,0,89,0,-89
3570,1,0,54,0,-54
3571,1,0,114,0,-114
3572,1,0,9,0,-9
3573,1,0,4,0,-4
3574,1,1,259,1403,1144
3575,1,1,483,1262,779
3576,1,0,175,0,-175
3577,1,1,79,1271,1192
3578,0,0,42,0,-42
3579,1,0,8,0,-8
3580,1,0,28,0,-28
3581,1,1,566,1518,952
3582,1,1,797,1781,984
3583,1,0,33,0,-33
3584,1,0,39,0,-39
3585,1,1,867,1368,501
3586,1,1,213,1380,1167
3587,1,1,1143,1980,837
3588,1,0,35,0,-35
3589,1,0,99,0,-99
3590,1,1,233,1235,1002
3591,1,0,30,0,-30
3592,1,0,145,0,-145
3593,0,0,24,0,-24
3594,0,0,4,0,-4
3595,0,0,41,0,-41
3596,1,0,6,0,-6
3597,1,0,5,0,-5
3598,1,0,41,0,-41
3599,0,0,111,0,-111
3600,1,1,54,1354,1300
3601,1,0,1,0,-1
3602,0,0,4,0,-4
3603,1,1,1226,1232,6
3604,1,0,63,0,-63
3605,1,0,50,0,-50
3606,1,1,55,1411,1356
3607,0,0,43,0,-43
3608,1,0,25,0,-25
3609,0,0,26,0,-26
3610,0,0,15,0,-15
3611,0,0,1,0,-1
3612,0,0,33,0,-33
3613,0,0,76,0,-76
3614,0,0,44,0,-44
3615,0,0,21,0,-21
3616,1,0,20,0,-20
3617,1,1,953,1209,256
3618,1,1,890,1694,804
3619,0,0,43,0,-43
3620,0,0,52,0,-52
3621,1,0,77,0,-77
3622,1,0,59,0,-59
3623,1,0,14,0,-14
3624,1,1,318,1222,904
3625,1,1,234,1815,1581
3626,1,0,8,0,-8
3627,1,1,848,1235,387
3628,0,0,120,0,-120
3629,1,0,72,0,-72
3630,1,1,1024,1668,644
3631,1,1,1068,1495,427
3632,0,0,30,0,-30
3633,0,0,317,0,-317
3634,0,0,20,0,-20
3635,1,1,114,1351,1237
3636,0,0,115,0,-115
3637,1,0,9,0,-9
3638,0,0,53,0,-53
3639,1,1,124,1513,1389
3640,0,0,97,0,-97
3641,0,0,48,0,-48
3642,1,1,172,1544,1372
3643,1,0,46,0,-46
3644,1,1,154,2140,1986
3645,1,1,411,1323,912
3646,1,1,333,1268,935
3647,1,0,3,0,-3
3648,0,0,330,0,-330
3649,0,0,43,0,-43
3650,1,0,35,0,-35
3651,0,0,20,0,-20
3652,1,0,17,0,-17
3653,1,0,5,0,-5
3654,0,0,2,0,-2
3655,0,0,9,0,-9
3656,1,1,843,1223,380
3657,1,0,9,0,-9
3658,0,0,20,0,-20
3659,1,1,1889,1316,-573
3660,1,0,65,0,-65
3661,1,1,118,1510,1392
3662,1,0,38,0,-38
3663,1,1,665,2069,1404
3664,1,0,3,0,-3
3665,0,0,150,0,-150
3666,1,1,143,1842,1699
3667,1,1,261,1299,1038
3668,1,1,330,1442,1112
3669,1,0,40,0,-40
3670,1,1,221,1694,1473
3671,0,0,8,0,-8
3672,0,0,96,0,-96
3673,0,0,18,0,-18
3674,0,0,18,0,-18
3675,0,0,99,0,-99
3676,0,0,50,0,-50
3677,1,1,219,1546,1327
3678,0,0,2,0,-2
3679,1,1,137,1205,1068
3680,1,1,597,1562,965
3681,0,0,45,0,-45
3682,1,1,153,1341,1188
3683,1,0,49,0,-49
3684,0,0,119,0,-119
3685,1,0,146,0,-146
3686,1,1,91,1640,1549
3687,1,1,218,2005,1787
3688,1,0,102,0,-102
3689,1,0,58,0,-58
3690,1,1,228,1225,997
3691,1,0,20,0,-20
3692,1,0,103,0,-103
3693,0,0,46,0,-46
3694,1,1,281,1308,1027
3695,0,0,7,0,-7
3696,1,1,329,3990,3661
3697,0,0,23,0,-23
3698,0,0,102,0,-102
3699,0,0,28,0,-28
3700,1,1,1061,1800,739
3701,0,0,21,0,-21
3702,1,1,539,1843,1304
3703,1,0,95,0,-95
3704,1,0,64,0,-64
3705,1,0,154,0,-154
3706,1,0,7,0,-7
3707,1,0,11,0,-11
3708,1,1,624,2757,2133
3709,1,0,74,0,-74
3710,1,1,490,1852,1362
3711,1,1,214,2266,2052
3712,0,0,42,0,-42
3713,0,0,46,0,-46
3714,1,1,135,1568,1433
3715,0,0,9,0,-9
3716,1,0,9,0,-9
3717,0,0,70,0,-70
3718,1,0,20,0,-20
3719,1,0,11,0,-11
3720,0,0,8,0,-8
3721,0,0,64,0,-64
3722,1,0,10,0,-10
3723,1,1,867,2342,1475
3724,1,0,24,0,-24
3725,0,0,13,0,-13
3726,0,0,3,0,-3
3727,1,1,1357,1348,-9
3728,1,1,388,1581,1193
3729,0,0,113,0,-113
3730,0,0,94,0,-94
3731,1,0,1,0,-1
3732,0,0,1,0,-1
3733,0,0,17,0,-17
3734,1,1,398,2031,1633
3735,1,0,8,0,-8
3736,1,0,24,0,-24
3737,0,0,10,0,-10
3738,0,0,44,0,-44
3739,1,1,218,1729,1511
3740,1,1,543,1411,868
3741,0,0,96,0,-96
3742,1,0,23,0,-23
3743,0,0,12,0,-12
3744,0,0,13,0,-13
3745,1,1,1075,1241,166
3746,1,1,542,1613,1071
3747,1,1,142,1306,1164
3748,1,1,941,1224,283
3749,1,1,84,1636,1552
3750,0,0,34,0,-34
3751,0,0,24,0,-24
3752,1,0,90,0,-90
3753,1,0,98,0,-98
3754,0,0,16,0,-16
3755,1,0,103,0,-103
3756,0,0,121,0,-121
3757,1,1,232,1412,1180
3758,1,1,140,1634,1494
3759,0,0,25,0,-25
3760,1,0,29,0,-29
3761,1,0,31,0,-31
3762,0,0,10,0,-10
3763,0,0,82,0,-82
3764,1,0,51,0,-51
3765,0,0,78,0,-78
3766,1,0,14,0,-14
3767,1,1,742,1527,785
3768,1,0,33,0,-33
3769,1,0,0,0,0
3770,0,0,3,0,-3
3771,1,0,45,0,-45
3772,1,0,17,0,-17
3773,1,0,21,0,-21
3774,0,0,13,0,-13
3775,0,0,28,0,-28
3776,1,0,33,0,-33
3777,1,1,285,1302,1017
3778,1,0,80,0,-80
3779,1,1,767,1549,782
3780,0,0,61,0,-61
3781,1,1,57,1208,1151
3782,1,0,42,0,-42
3783,1,0,5,0,-5
3784,1,1,372,2191,1819
3785,0,0,42,0,-42
3786,1,1,135,1259,1124
3787,0,0,106,0,-106
3788,0,0,63,0,-63
3789,1,1,759,1350,591
3790,0,0,80,0,-80
3791,1,0,50,0,-50
3792,1,1,64,1473,1409
3793,0,0,115,0,-115
3794,1,1,1210,1412,202
3795,1,1,679,1843,1164
3796,1,0,5,0,-5
3797,0,0,54,0,-54
3798,0,0,150,0,-150
3799,1,1,570,1553,983
3800,0,0,19,0,-19
3801,0,0,182,0,-182
3802,0,0,42,0,-42
3803,1,1,1107,1663,556
3804,0,0,56,0,-56
3805,0,0,9,0,-9
3806,1,0,1,0,-1
3807,1,1,1185,1355,170
3808,0,0,8,0,-8
3809,0,0,124,0,-124
3810,1,0,141,0,-141
3811,0,0,17,0,-17
3812,0,0,41,0,-41
3813,1,0,75,0,-75
3814,0,0,60,0,-60
3815,0,0,63,0,-63
3816,0,0,134,0,-134
3817,1,0,80,0,-80
3818,0,0,6,0,-6
3819,0,0,30,0,-30
3820,0,0,11,0,-11
3821,0,0,16,0,-16
3822,1,1,115,1382,1267
3823,1,1,117,1351,1234
3824,0,0,80,0,-80
3825,1,0,215,0,-215
3826,0,0,164,0,-164
3827,0,0,26,0,-26
3828,1,0,115,0,-115
3829,1,1,964,1652,688
3830,0,0,46,0,-46
3831,0,0,3,0,-3
3832,1,0,25,0,-25
3833,0,0,12,0,-12
3834,0,0,0,0,0
3835,1,1,377,1537,1160
3836,1,0,27,0,-27
3837,1,0,36,0,-36
3838,1,0,8,0,-8
3839,0,0,1,0,-1
3840,0,0,37,0,-37
3841,0,0,2,0,-2
3842,0,0,54,0,-54
3843,1,0,13,0,-13
3844,1,0,96,0,-96
3845,1,0,31,0,-31
3846,1,0,22,0,-22
3847,1,0,63,0,-63
3848,1,1,939,1545,606
3849,1,0,5,0,-5
3850,1,0,50,0,-50
3851,1,0,32,0,-32
3852,0,0,124,0,-124
3853,1,0,7,0,-7
3854,1,1,829,1442,613
3855,1,1,1439,1334,-105
3856,1,0,43,0,-43
3857,0,0,82,0,-82
3858,0,0,3,0,-3
3859,0,0,12,0,-12
3860,0,0,61,0,-61
3861,0,0,7,0,-7
3862,1,1,400,1750,1350
3863,1,0,25,0,-25
3864,0,0,48,0,-48
3865,1,1,756,1765,1009
3866,1,1,24,1502,1478
3867,1,1,331,2126,1795
3868,0,0,100,0,-100
3869,0,0,31,0,-31
3870,0,0,25,0,-25
3871,0,0,36,0,-36
3872,1,0,17,0,-17
3873,0,0,10,0,-10
3874,0,0,7,0,-7
3875,0,0,70,0,-70
3876,0,0,163,0,-163
3877,1,0,8,0,-8
3878,0,0,0,0,0
3879,1,1,1104,1396,292
3880,1,1,743,1267,524
3881,1,1,181,1817,1636
3882,1,0,36,0,-36
3883,1,0,48,0,-48
3884,1,1,614,2774,2160
3885,1,0,27,0,-27
3886,1,0,170,0,-170
3887,0,0,23,0,-23
3888,0,0,48,0,-48
3889,1,0,9,0,-9
3890,1,1,1612,1237,-375
3891,0,0,113,0,-113
3892,0,0,36,0,-36
3893,0,0,19,0,-19
3894,0,0,40,0,-40
3895,0,0,21,0,-21
3896,1,0,77,0,-77
3897,0,0,41,0,-41
3898,0,0,21,0,-21
3899,1,1,429,1726,1297
3900,0,0,332,0,-332
3901,0,0,55,0,-55
3902,1,1,922,1200,278
3903,0,0,1,0,-1
3904,1,1,727,1342,615
3905,1,1,417,1429,1012
3906,0,0,21,0,-21
3907,0,0,28,0,-28
3908,0,0,54,0,-54
3909,1,1,1488,1494,6
3910,1,0,206,0,-206
3911,1,1,260,1265,1005
3912,0,0,1,0,-1
3913,1,0,32,0,-32
3914,0,0,72,0,-72
3915,0,0,24,0,-24
3916,1,0,33,0,-33
3917,1,0,89,0,-89
3918,1,1,554,1349,795
3919,0,0,30,0,-30
3920,1,0,57,0,-57
3921,0,0,38,0,-38
3922,1,1,597,1314,717
3923,0,0,10,0,-10
3924,1,1,1010,1587,577
3925,0,0,55,0,-55
3926,0,0,12,0,-12
3927,0,0,203,0,-203
3928,1,0,1,0,-1
3929,0,0,0,0,0
3930,1,1,53,1272,1219
3931,0,0,28,0,-28
3932,1,1,650,1330,680
3933,1,1,77,1355,1278
3934,1,1,214,1607,1393
3935,1,1,128,5030,4902
3936,0,0,43,0,-43
3937,1,1,459,1391,932
3938,1,0,24,0,-24
3939,1,1,44,1593,1549
3940,1,1,142,1523,1381
3941,1,1,717,1471,754
3942,0,0,73,0,-73
3943,1,1,229,2172,1943
3944,0,0,20,0,-20
3945,1,0,65,0,-65
3946,0,0,21,0,-21
3947,1,0,2,0,-2
3948,0,0,46,0,-46
3949,1,1,75,1500,1425
3950,0,0,43,0,-43
3951,1,0,52,0,-52
3952,0,0,94,0,-94
3953,0,0,34,0,-34
3954,0,0,63,0,-63
3955,0,0,48,0,-48
3956,1,1,516,2379,1863
3957,1,1,715,1310,595
3958,0,0,150,0,-150
3959,1,1,2254,1294,-960
3960,0,0,28,0,-28
3961,0,0,21,0,-21
3962,1,0,131,0,-131
3963,0,0,141,0,-141
3964,0,0,90,0,-90
3965,1,0,75,0,-75
3966,1,0,32,0,-32
3967,0,0,64,0,-64
3968,0,0,25,0,-25
3969,0,0,1,0,-1
3970,0,0,44,0,-44
3971,1,1,1639,1891,252
3972,1,1,36,1285,1249
3973,1,1,349,1469,1120
3974,0,0,10,0,-10
3975,1,0,32,0,-32
3976,1,0,54,0,-54
3977,0,0,92,0,-92
3978,1,1,91,1513,1422
3979,0,0,34,0,-34
3980,1,1,279,1340,1061
3981,1,0,38,0,-38
3982,1,1,257,1248,991
3983,1,0,10,0,-10
3984,1,1,459,1398,939
3985,0,0,11,0,-11
3986,1,0,52,0,-52
3987,1,0,65,0,-65
3988,1,1,1610,1220,-390
3989,1,0,21,0,-21
3990,0,0,83,0,-83
3991,1,0,2,0,-2
3992,1,0,15,0,-15
3993,0,0,11,0,-11
3994,1,0,40,0,-40
3995,1,0,68,0,-68
3996,0,0,85,0,-85
3997,1,0,0,0,0
3998,0,0,77,0,-77
3999,0,0,9,0,-9
4000,1,1,776,2957,2181
4001,1,1,437,1342,905
4002,1,0,43,0,-43
4003,1,1,233,1441,1208
4004,1,0,48,0,-48
4005,1,1,1102,1225,123
4006,1,0,66,0,-66
4007,0,0,62,0,-62
4008,0,0,24,0,-24
4009,1,1,1258,1573,315
4010,1,1,1433,1570,137
4011,0,0,8,0,-8
4012,1,0,82,0,-82
4013,0,0,92,0,-92
4014,1,0,29,0,-29
4015,1,0,118,0,-118
4016,1,0,74,0,-74
4017,1,0,2,0,-2
4018,1,0,121,0,-121
4019,1,1,283,1604,1321
4020,0,0,27,0,-27
4021,0,0,66,0,-66
4022,1,0,154,0,-154
4023,1,1,1009,1346,337
4024,1,0,12,0,-12
4025,1,1,1301,2678,1377
4026,0,0,0,0,0
4027,0,0,27,0,-27
4028,0,0,32,0,-32
4029,0,0,41,0,-41
4030,0,0,17,0,-17
4031,0,0,13,0,-13
4032,1,0,40,0,-40
4033,0,0,52,0,-52
4034,0,0,75,0,-75
4035,1,0,0,0,0
4036,1,1,125,1235,1110
4037,1,0,125,0,-125
4038,1,0,1,0,-1
4039,1,1,562,2463,1901
4040,1,1,473,1598,1125
4041,1,0,10,0,-10
4042,1,0,16,0,-16
4043,1,0,148,0,-148
4044,1,1,190,1455,1265
4045,1,1,155,1756,1601
4046,0,0,77,0,-77
4047,0,0,207,0,-207
4048,0,0,15,0,-15
4049,1,1,109,1785,1676
4050,1,0,67,0,-67
4051,0,0,12,0,-12
4052,0,0,37,0,-37
4053,0,0,16,0,-16
4054,0,0,19,0,-19
4055,0,0,53,0,-53
4056,0,0,109,0,-109
4057,1,1,667,1709,1042
4058,1,1,364,1233,869
4059,1,0,22,0,-22
4060,0,0,79,0,-79
4061,1,1,108,1447,1339
4062,1,1,741,1660,919
4063,0,0,87,0,-87
4064,1,1,1381,1335,-46
4065,1,0,164,0,-164
4066,0,0,25,0,-25
4067,0,0,39,0,-39
4068,1,1,494,1209,715
4069,1,1,616,1234,618
4070,0,0,14,0,-14
4071,1,1,218,2425,2207
4072,0,0,30,0,-30
4073,0,0,85,0,-85
4074,1,0,39,0,-39
4075,1,1,93,3370,3277
4076,0,0,94,0,-94
4077,0,0,14,0,-14
4078,0,0,12,0,-12
4079,0,0,34,0,-34
4080,1,1,660,1288,628
4081,1,0,1,0,-1
4082,1,1,397,1286,889
4083,1,1,679,1775,1096
4084,0,0,18,0,-18
4085,1,1,450,1260,810
4086,0,0,22,0,-22
4087,0,0,82,0,-82
4088,0,0,35,0,-35
4089,1,0,120,0,-120
4090,1,1,569,1510,941
4091,1,1,1299,1722,423
4092,0,0,30,0,-30
4093,1,0,73,0,-73
4094,0,0,31,0,-31
4095,1,1,99,2057,1958
4096,1,0,10,0,-10
4097,0,0,33,0,-33
4098,1,1,80,1544,1464
4099,1,0,14,0,-14
4100,1,0,11,0,-11
4101,0,0,32,0,-32
4102,0,0,36,0,-36
4103,0,0,41,0,-41
4104,1,0,57,0,-57
4105,0,0,50,0,-50
4106,0,0,12,0,-12
4107,0,0,34,0,-34
4108,1,1,147,1247,1100
4109,1,1,678,1353,675
4110,1,1,433,1414,981
4111,0,0,22,0,-22
4112,1,1,389,1221,832
4113,1,1,725,3939,3214
4114,1,0,323,0,-323
4115,1,0,30,0,-30
4116,1,1,64,1307,1243
4117,1,0,71,0,-71
4118,1,0,10,0,-10
4119,0,0,28,0,-28
4120,1,1,166,1665,1499
4121,1,0,18,0,-18
4122,1,1,227,1858,1631
4123,1,1,22,1265,1243
4124,1,0,47,0,-47
4125,1,0,13,0,-13
4126,1,1,378,2511,2133
4127,1,1,885,1244,359
4128,0,0,86,0,-86
4129,1,1,52,1816,1764
4130,1,1,924,1241,317
4131,0,0,46,0,-46
4132,0,0,94,0,-94
4133,0,0,137,0,-137
4134,0,0,65,0,-65
4135,0,0,35,0,-35
4136,1,0,38,0,-38
4137,1,1,428,1478,1050
4138,1,1,533,1629,1096
4139,1,1,648,1316,668
4140,1,0,64,0,-64
4141,1,0,10,0,-10
4142,1,1,1676,1321,-355
4143,0,0,18,0,-18
4144,0,0,49,0,-49
4145,1,1,114,2490,2376
4146,0,0,19,0,-19
4147,0,0,31,0,-31
4148,1,0,17,0,-17
4149,1,1,559,1672,1113
4150,1,0,0,0,0
4151,1,1,307,1245,938
4152,1,0,26,0,-26
4153,1,0,3,0,-3
4154,1,0,121,0,-121
4155,0,0,32,0,-32
4156,0,0,294,0,-294
4157,1,0,19,0,-19
4158,1,0,68,0,-68
4159,0,0,36,0,-36
4160,0,0,0,0,0
4161,1,1,1154,1866,712
4162,0,0,67,0,-67
4163,1,1,952,1556,604
4164,1,0,60,0,-60
4165,1,0,174,0,-174
4166,0,0,21,0,-21
4167,1,1,813,1614,801
4168,0,0,24,0,-24
4169,1,1,162,1295,1133
4170,1,1,252,1613,1361
4171,1,1,246,1337,1091
4172,0,0,326,0,-326
4173,1,0,74,0,-74
4174,0,0,168,0,-168
4175,0,0,40,0,-40
4176,1,1,841,1303,462
4177,1,0,24,0,-24
4178,1,1,41,1361,1320
4179,1,0,37,0,-37
4180,1,0,36,0,-36
4181,0,0,44,0,-44
4182,1,0,72,0,-72
4183,1,0,22,0,-22
4184,1,0,5,0,-5
4185,0,0,5,0,-5
4186,0,0,34,0,-34
4187,0,0,9,0,-9
4188,0,0,2,0,-2
4189,0,0,17,0,-17
4190,1,0,342,0,-342
4191,0,0,6,0,-6
4192,1,1,88,1354,1266
4193,0,0,17,0,-17
4194,0,0,8,0,-8
4195,0,0,16,0,-16
4196,0,0,92,0,-92
4197,1,0,55,0,-55
4198,1,0,149,0,-149
4199,0,0,22,0,-22
4200,0,0,97,0,-97
4201,1,1,1158,1423,265
4202,1,0,14,0,-14
4203,1,0,193,0,-193
4204,0,0,4,0,-4
4205,1,0,64,0,-64
4206,1,1,282,1218,936
4207,0,0,54,0,-54
4208,0,0,64,0,-64
4209,0,0,176,0,-176
4210,0,0,31,0,-31
4211,1,1,1591,1395,-196
4212,1,1,3066,2278,-788
4213,1,0,44,0,-44
4214,1,0,44,0,-44
4215,1,1,1091,1575,484
4216,1,0,16,0,-16
4217,1,0,21,0,-21
4218,1,0,1,0,-1
4219,0,0,108,0,-108
4220,1,1,1322,1225,-97
4221,1,1,375,1450,1075
4222,1,0,7,0,-7
4223,0,0,8,0,-8
4224,1,1,422,1317,895
4225,1,1,218,2450,2232
4226,0,0,42,0,-42
4227,1,1,868,1283,415
4228,1,0,29,0,-29
4229,1,1,103,3155,3052
4230,1,1,231,1252,1021
4231,0,0,88,0,-88
4232,0,0,20,0,-20
4233,1,1,961,1300,339
4234,1,1,792,1475,683
4235,0,0,11,0,-11
4236,1,1,97,1220,1123
4237,0,0,37,0,-37
4238,0,0,107,0,-107
4239,1,1,592,1615,1023
4240,1,0,18,0,-18
4241,1,0,8,0,-8
4242,1,0,32,0,-32
4243,1,1,1427,1347,-80
4244,0,0,96,0,-96
4245,1,1,1040,1281,241
4246,0,0,53,0,-53
4247,1,0,61,0,-61
4248,0,0,10,0,-10
4249,0,0,77,0,-77
4250,1,0,64,0,-64
4251,0,0,42,0,-42
4252,0,0,33,0,-33
4253,0,0,3,0,-3
4254,1,1,361,1279,918
4255,1,0,8,0,-8
4256,1,1,186,1274,1088
4257,0,0,75,0,-75
4258,0,0,13,0,-13
4259,1,0,8,0,-8
4260,1,0,38,0,-38
4261,0,0,12,0,-12
4262,1,1,620,1351,731
4263,1,0,21,0,-21
4264,1,1,250,2344,2094
4265,1,0,6,0,-6
4266,0,0,9,0,-9
4267,0,0,17,0,-17
4268,0,0,113,0,-113
4269,1,0,5,0,-5
4270,0,0,17,0,-17
4271,0,0,120,0,-120
4272,1,0,43,0,-43
4273,1,1,65,1908,1843
4274,1,0,77,0,-77
4275,1,1,983,1447,464
4276,0,0,114,0,-114
4277,0,0,24,0,-24
4278,1,0,18,0,-18
4279,1,0,16,0,-16
4280,1,1,252,1293,1041
4281,0,0,14,0,-14
4282,1,1,280,2045,1765
4283,0,0,54,0,-54
4284,0,0,46,0,-46
4285,1,1,454,1512,1058
4286,0,0,33,0,-33
4287,1,1,40,1261,1221
4288,0,0,82,0,-82
4289,1,1,1679,1321,-358
4290,0,0,8,0,-8
4291,1,1,647,1273,626
4292,0,0,63,0,-63
4293,1,0,37,0,-37
4294,0,0,41,0,-41
4295,1,0,71,0,-71
4296,0,0,51,0,-51
4297,1,1,687,1378,691
4298,0,0,4,0,-4
4299,1,1,1108,1329,221
4300,1,1,602,1628,1026
4301,0,0,25,0,-25
4302,1,1,589,1418,829
4303,1,1,83,1774,1691
4304,0,0,43,0,-43
4305,0,0,7,0,-7
4306,1,0,41,0,-41
4307,0,0,183,0,-183
4308,1,0,5,0,-5
4309,1,0,181,0,-181
4310,1,0,10,0,-10
4311,1,1,270,1287,1017
4312,1,0,49,0,-49
4313,0,0,21,0,-21
4314,0,0,63,0,-63
4315,1,1,805,2077,1272
4316,1,0,12,0,-12
4317,0,0,4,0,-4
4318,1,0,32,0,-32
4319,1,0,31,0,-31
4320,1,1,227,2620,2393
4321,1,1,188,1245,1057
4322,1,1,1520,1677,157
4323,1,0,34,0,-34
4324,0,0,13,0,-13
4325,1,1,477,1202,725
4326,0,0,44,0,-44
4327,1,1,243,1344,1101
4328,1,0,5,0,-5
4329,1,0,4,0,-4
4330,1,0,9,0,-9
4331,1,1,167,5153,4986
4332,1,0,5,0,-5
4333,1,0,18,0,-18
4334,1,1,128,1454,1326
4335,1,1,320,2283,1963
4336,1,1,301,1450,1149
4337,0,0,33,0,-33
4338,0,0,0,0,0
4339,1,1,121,1721,1600
4340,0,0,30,0,-30
4341,0,0,30,0,-30
4342,1,0,116,0,-116
4343,0,0,76,0,-76
4344,0,0,59,0,-59
4345,1,1,102,1346,1244
4346,1,1,988,1254,266
4347,0,0,147,0,-147
4348,1,1,374,2129,1755
4349,0,0,2,0,-2
4350,0,0,18,0,-18
4351,1,0,78,0,-78
4352,1,0,33,0,-33
4353,1,0,43,0,-43
4354,1,0,38,0,-38
4355,1,1,526,2757,2231
4356,0,0,12,0,-12
4357,1,1,476,1312,836
4358,0,0,50,0,-50
4359,1,0,60,0,-60
4360,1,0,98,0,-98
4361,1,0,8,0,-8
4362,0,0,37,0,-37
4363,1,1,127,1202,1075
4364,1,0,21,0,-21
4365,1,1,263,1207,944
4366,0,0,6,0,-6
4367,1,1,2334,1214,-1120
4368,0,0,31,0,-31
4369,1,0,30,0,-30
4370,0,0,11,0,-11
4371,1,1,1817,1455,-362
4372,1,0,38,0,-38
4373,1,1,310,1209,899
4374,0,0,20,0,-20
4375,0,0,155,0,-155
4376,0,0,5,0,-5
4377,0,0,78,0,-78
4378,0,0,18,0,-18
4379,1,0,8,0,-8
4380,0,0,187,0,-187
4381,1,1,178,2165,1987
4382,1,1,773,1280,507
4383,0,0,48,0,-48
4384,0,0,97,0,-97
4385,1,1,486,1490,1004
4386,0,0,176,0,-176
4387,0,0,86,0,-86
4388,0,0,42,0,-42
4389,1,1,952,1213,261
4390,0,0,22,0,-22
4391,1,1,792,1333,541
4392,1,0,40,0,-40
4393,1,0,5,0,-5
4394,1,0,51,0,-51
4395,1,1,1004,1289,285
4396,0,0,42,0,-42
4397,1,1,603,1201,598
4398,0,0,92,0,-92
4399,1,1,664,1364,700
4400,1,0,1,0,-1
4401,1,1,531,2586,2055
4402,1,0,95,0,-95
4403,0,0,157,0,-157
4404,0,0,38,0,-38
4405,0,0,61,0,-61
4406,1,1,428,1782,1354
4407,1,1,306,1271,965
4408,1,0,52,0,-52
4409,1,0,2,0,-2
4410,1,1,311,1398,1087
4411,1,0,159,0,-159
4412,1,1,398,1314,916
4413,0,0,22,0,-22
4414,0,0,60,0,-60
4415,1,1,147,1818,1671
4416,1,1,1797,1285,-512
4417,1,0,80,0,-80
4418,1,1,164,1837,1673
4419,0,0,57,0,-57
4420,1,0,25,0,-25
4421,1,1,382,2710,2328
4422,1,1,479,1471,992
4423,1,0,2,0,-2
4424,0,0,2,0,-2
4425,0,0,204,0,-204
4426,1,0,14,0,-14
4427,0,0,24,0,-24
4428,1,0,58,0,-58
4429,1,1,926,1648,722
4430,1,0,6,0,-6
4431,0,0,1,0,-1
4432,1,0,40,0,-40
4433,1,1,171,1256,1085
4434,1,0,61,0,-61
4435,1,1,207,1634,1427
4436,1,1,234,1539,1305
4437,0,0,16,0,-16
4438,1,0,39,0,-39
4439,1,1,346,2498,2152
4440,1,0,102,0,-102
4441,0,0,45,0,-45
4442,1,0,1,0,-1
4443,0,0,79,0,-79
4444,1,1,151,2382,2231
4445,1,1,2483,1805,-678
4446,0,0,33,0,-33
4447,0,0,25,0,-25
4448,1,0,90,0,-90
4449,1,0,113,0,-113
4450,0,0,63,0,-63
4451,1,1,503,1348,845
4452,0,0,39,0,-39
4453,0,0,37,0,-37
4454,1,0,169,0,-169
4455,1,0,191,0,-191
4456,1,0,5,0,-5
4457,1,0,54,0,-54
4458,0,0,158,0,-158
4459,1,0,8,0,-8
4460,1,1,163,1344,1181
4461,1,0,30,0,-30
4462,0,0,31,0,-31
4463,1,0,101,0,-101
4464,1,1,234,1331,1097
4465,0,0,80,0,-80
4466,1,1,509,2308,1799
4467,0,0,18,0,-18
4468,0,0,2,0,-2
4469,1,0,120,0,-120
4470,1,0,59,0,-59
4471,1,0,7,0,-7
4472,0,0,21,0,-21
4473,1,0,58,0,-58
4474,0,0,9,0,-9
4475,0,0,65,0,-65
4476,0,0,15,0,-15
4477,1,1,693,1279,586
4478,1,1,914,1941,1027
4479,1,0,65,0,-65
4480,0,0,1,0,-1
4481,0,0,8,0,-8
4482,0,0,19,0,-19
4483,0,0,127,0,-127
4484,1,1,67,1567,1500
4485,1,0,17,0,-17
4486,1,0,2,0,-2
4487,0,0,46,0,-46
4488,1,0,12,0,-12
4489,0,0,64,0,-64
4490,0,0,7,0,-7
4491,1,0,82,0,-82
4492,1,0,47,0,-47
4493,0,0,36,0,-36
4494,0,0,11,0,-11
4495,1,0,37,0,-37
4496,0,0,10,0,-10
4497,1,1,639,1715,1076
4498,1,1,575,1967,1392
4499,1,1,643,1632,989
4500,1,1,158,1374,1216
4501,0,0,18,0,-18
4502,0,0,122,0,-122
4503,0,0,10,0,-10
4504,1,0,13,0,-13
4505,1,1,32,1268,1236
4506,1,1,997,1435,438
4507,1,1,457,1524,1067
4508,0,0,48,0,-48
4509,0,0,4,0,-4
4510,1,0,122,0,-122
4511,1,1,219,1793,1574
4512,1,1,676,1301,625
4513,0,0,60,0,-60
4514,1,0,24,0,-24
4515,0,0,78,0,-78
4516,1,0,30,0,-30
4517,1,1,1579,1222,-357
4518,1,1,836,1369,533
4519,0,0,34,0,-34
4520,1,1,372,1613,1241
4521,0,0,63,0,-63
4522,1,0,75,0,-75
4523,1,1,125,1424,1299
4524,1,1,124,1267,1143
4525,1,0,53,0,-53
4526,0,0,65,0,-65
4527,1,1,325,1316,991
4528,1,1,1802,1326,-476
4529,1,0,52,0,-52
4530,1,0,71,0,-71
4531,1,0,3,0,-3
4532,1,1,468,1450,982
4533,0,0,64,0,-64
4534,0,0,273,0,-273
4535,0,0,18,0,-18
4536,0,0,49,0,-49
4537,0,0,27,0,-27
4538,0,0,77,0,-77
4539,1,1,319,1965,1646
4540,1,0,7,0,-7
4541,1,0,153,0,-153
4542,0,0,32,0,-32
4543,0,0,70,0,-70
4544,0,0,4,0,-4
4545,1,1,1010,1404,394
4546,0,0,128,0,-128
4547,1,1,425,1285,860
4548,1,0,6,0,-6
4549,1,1,1276,1369,93
4550,0,0,273,0,-273
4551,1,1,402,1322,920
4552,1,1,635,1672,1037
4553,1,1,250,1419,1169
4554,1,1,121,1209,1088
4555,1,1,623,1898,1275
4556,1,1,511,1376,865
4557,0,0,21,0,-21
4558,1,1,110,2044,1934
4559,0,0,159,0,-159
4560,1,0,84,0,-84
4561,0,0,7,0,-7
4562,0,0,13,0,-13
4563,0,0,43,0,-43
4564,1,0,81,0,-81
4565,1,0,7,0,-7
4566,1,1,1232,1457,225
4567,0,0,152,0,-152
4568,1,0,13,0,-13
4569,0,0,200,0,-200
4570,1,0,47,0,-47
4571,1,1,123,1243,1120
4572,1,0,27,0,-27
4573,0,0,66,0,-66
4574,1,1,2301,1338,-963
4575,1,0,29,0,-29
4576,1,0,0,0,0
4577,1,0,3,0,-3
4578,0,0,19,0,-19
4579,0,0,18,0,-18
4580,1,0,33,0,-33
4581,0,0,71,0,-71
4582,1,1,178,1283,1105
4583,0,0,54,0,-54
4584,1,0,16,0,-16
4585,1,1,174,1295,1121
4586,1,1,621,1344,723
4587,0,0,81,0,-81
4588,1,1,2197,1560,-637
4589,1,0,1,0,-1
4590,1,1,880,1213,333
4591,1,1,304,1215,911
4592,0,0,17,0,-17
4593,1,1,620,1405,785
4594,0,0,7,0,-7
4595,0,0,98,0,-98
4596,1,1,534,1852,1318
4597,1,0,14,0,-14
4598,0,0,71,0,-71
4599,1,0,132,0,-132
4600,1,1,117,1358,1241
4601,1,1,1225,2965,1740
4602,0,0,2,0,-2
4603,1,1,462,1619,1157
4604,0,0,26,0,-26
4605,1,0,59,0,-59
4606,1,0,82,0,-82
4607,1,0,0,0,0
4608,1,1,749,1473,724
4609,0,0,1,0,-1
4610,1,1,194,1206,1012
4611,1,0,23,0,-23
4612,0,0,3,0,-3
4613,1,1,186,1219,1033
4614,0,0,13,0,-13
4615,1,1,584,1413,829
4616,1,1,607,1274,667
4617,1,1,257,1328,1071
4618,1,1,751,1206,455
4619,0,0,13,0,-13
4620,0,0,18,0,-18
4621,0,0,29,0,-29
4622,0,0,80,0,-80
4623,1,1,754,1213,459
4624,0,0,0,0,0
4625,1,0,160,0,-160
4626,1,0,88,0,-88
4627,0,0,46,0,-46
4628,1,0,27,0,-27
4629,1,0,75,0,-75
4630,1,0,0,0,0
4631,1,0,57,0,-57
4632,0,0,138,0,-138
4633,0,0,92,0,-92
4634,1,0,67,0,-67
4635,1,1,371,1422,1051
4636,0,0,15,0,-15
4637,1,0,33,0,-33
4638,1,1,226,1213,987
4639,0,0,8,0,-8
4640,1,0,40,0,-40
4641,0,0,4,0,-4
4642,1,1,398,1210,812
4643,0,0,81,0,-81
4644,1,0,36,0,-36
4645,1,1,575,1328,753
4646,1,0,4,0,-4
4647,0,0,75,0,-75
4648,1,1,489,1204,715
4649,1,1,851,1200,349
4650,1,1,978,1705,727
4651,0,0,75,0,-75
4652,1,0,27,0,-27
4653,1,1,287,1214,927
4654,0,0,0,0,0
4655,1,1,2158,2206,48
4656,1,1,687,1438,751
4657,0,0,0,0,0
4658,1,0,21,0,-21
4659,0,0,37,0,-37
4660,1,1,139,1417,1278
4661,0,0,48,0,-48
4662,0,0,74,0,-74
4663,1,1,1262,1636,374
4664,1,0,29,0,-29
4665,0,0,58,0,-58
4666,1,0,25,0,-25
4667,0,0,17,0,-17
4668,1,1,143,1544,1401
4669,0,0,69,0,-69
4670,1,1,560,1236,676
4671,1,1,423,1731,1308
4672,1,1,224,2063,1839
4673,0,0,17,0,-17
4674,1,1,1115,1733,618
4675,1,1,143,1850,1707
4676,0,0,49,0,-49
4677,1,1,275,1887,1612
4678,1,0,53,0,-53
4679,1,0,86,0,-86
4680,0,0,16,0,-16
4681,1,1,1673,1729,56
4682,1,0,0,0,0
4683,0,0,10,0,-10
4684,0,0,145,0,-145
4685,1,1,482,2002,1520
4686,1,1,232,1981,1749
4687,0,0,68,0,-68
4688,1,1,35,1250,1215
4689,1,0,122,0,-122
4690,0,0,12,0,-12
4691,0,0,48,0,-48
4692,0,0,75,0,-75
4693,1,0,10,0,-10
4694,0,0,91,0,-91
4695,0,0,14,0,-14
4696,0,0,14,0,-14
4697,1,0,44,0,-44
4698,0,0,1,0,-1
4699,1,1,288,2004,1716
4700,1,1,1827,1797,-30
4701,0,0,45,0,-45
4702,0,0,67,0,-67
4703,0,0,63,0,-63
4704,0,0,45,0,-45
4705,1,1,1095,1379,284
4706,1,0,17,0,-17
4707,0,0,6,0,-6
4708,1,1,150,1450,1300
4709,0,0,0,0,0
4710,0,0,155,0,-155
4711,1,1,791,1799,1008
4712,1,0,0,0,0
4713,1,1,702,1391,689
4714,1,0,7,0,-7
4715,1,1,446,1215,769
4716,0,0,52,0,-52
4717,1,0,9,0,-9
4718,1,0,39,0,-39
4719,0,0,155,0,-155
4720,0,0,181,0,-181
4721,1,0,32,0,-32
4722,0,0,5,0,-5
4723,1,1,533,1351,818
4724,0,0,233,0,-233
4725,1,1,272,1449,1177
4726,0,0,16,0,-16
4727,1,0,55,0,-55
4728,1,0,80,0,-80
4729,1,1,138,2370,2232
4730,0,0,44,0,-44
4731,1,1,668,1768,1100
4732,1,1,818,1736,918
4733,0,0,81,0,-81
4734,1,1,14,1279,1265
4735,0,0,149,0,-149
4736,1,1,919,1252,333
4737,1,0,126,0,-126
4738,1,0,40,0,-40
4739,0,0,101,0,-101
4740,1,0,38,0,-38
4741,1,0,17,0,-17
4742,0,0,23,0,-23
4743,1,0,99,0,-99
4744,1,0,43,0,-43
4745,1,0,93,0,-93
4746,1,1,362,1309,947
4747,0,0,76,0,-76
4748,1,1,199,1210,1011
4749,0,0,146,0,-146
4750,1,0,49,0,-49
4751,0,0,221,0,-221
4752,1,1,41,1346,1305
4753,1,0,66,0,-66
4754,1,0,8,0,-8
4755,1,1,151,1260,1109
4756,0,0,161,0,-161
4757,0,0,56,0,-56
4758,1,1,1628,3887,2259
4759,1,1,129,1420,1291
4760,1,1,1389,1493,104
4761,1,0,84,0,-84
4762,1,1,484,1374,890
4763,1,0,40,0,-40
4764,1,0,3,0,-3
4765,1,0,33,0,-33
4766,0,0,4,0,-4
4767,0,0,46,0,-46
4768,1,1,1778,1449,-329
4769,0,0,33,0,-33
4770,1,0,90,0,-90
4771,1,0,1,0,-1
4772,0,0,38,0,-38
4773,1,1,172,2625,2453
4774,0,0,65,0,-65
4775,1,0,74,0,-74
4776,1,1,48,1838,1790
4777,0,0,101,0,-101
4778,0,0,66,0,-66
4779,1,0,25,0,-25
4780,0,0,114,0,-114
4781,0,0,16,0,-16
4782,1,1,989,1607,618
4783,0,0,50,0,-50
4784,0,0,19,0,-19
4785,1,0,20,0,-20
4786,1,0,23,0,-23
4787,0,0,52,0,-52
4788,0,0,62,0,-62
4789,0,0,47,0,-47
4790,1,0,15,0,-15
4791,1,0,5,0,-5
4792,0,0,55,0,-55
4793,1,0,11,0,-11
4794,1,1,330,1406,1076
4795,1,0,3,0,-3
4796,1,0,3,0,-3
4797,1,1,408,1221,813
4798,0,0,66,0,-66
4799,0,0,31,0,-31
4800,1,0,33,0,-33
4801,1,0,3,0,-3
4802,1,0,10,0,-10
4803,1,0,113,0,-113
4804,1,1,376,1261,885
4805,0,0,51,0,-51
4806,1,1,958,2514,1556
4807,1,0,0,0,0
4808,1,1,147,1367,1220
4809,1,1,475,1966,1491
4810,1,0,226,0,-226
4811,1,1,217,1362,1145
4812,1,1,1716,2573,857
4813,1,1,67,1363,1296
4814,0,0,13,0,-13
4815,0,0,13,0,-13
4816,0,0,21,0,-21
4817,0,0,26,0,-26
4818,1,1,815,1302,487
4819,0,0,56,0,-56
4820,1,0,125,0,-125
4821,0,0,117,0,-117
4822,0,0,15,0,-15
4823,0,0,11,0,-11
4824,0,0,31,0,-31
4825,1,0,11,0,-11
4826,1,1,1616,1364,-252
4827,1,1,2212,1262,-950
4828,1,1,89,1231,1142
4829,1,0,40,0,-40
4830,0,0,12,0,-12
4831,1,1,1637,1403,-234
4832,1,0,105,0,-105
4833,0,0,104,0,-104
4834,0,0,9,0,-9
4835,0,0,205,0,-205
4836,1,1,171,1630,1459
4837,1,0,20,0,-20
4838,0,0,23,0,-23
4839,1,0,19,0,-19
4840,1,1,253,3267,3014
4841,0,0,34,0,-34
4842,1,1,3305,1361,-1944
4843,0,0,35,0,-35
4844,0,0,107,0,-107
4845,1,1,605,1413,808
4846,1,0,118,0,-118
4847,0,0,19,0,-19
4848,0,0,26,0,-26
4849,1,1,873,1859,986
4850,0,0,61,0,-61
4851,0,0,13,0,-13
4852,1,0,4,0,-4
4853,0,0,73,0,-73
4854,1,0,17,0,-17
4855,0,0,8,0,-8
4856,1,0,32,0,-32
4857,1,1,99,1370,1271
4858,1,0,1,0,-1
4859,1,0,188,0,-188
4860,1,1,291,1284,993
4861,1,1,489,1440,951
4862,0,0,78,0,-78
4863,1,0,40,0,-40
4864,1,1,255,1249,994
4865,1,0,97,0,-97
4866,0,0,9,0,-9
4867,1,1,1220,1885,665
4868,0,0,10,0,-10
4869,0,0,77,0,-77
4870,1,0,13,0,-13
4871,1,1,311,1235,924
4872,1,0,70,0,-70
4873,0,0,90,0,-90
4874,1,1,139,1493,1354
4875,1,0,3,0,-3
4876,1,1,213,1436,1223
4877,0,0,38,0,-38
4878,0,0,58,0,-58
4879,0,0,0,0,0
4880,1,0,87,0,-87
4881,1,0,64,0,-64
4882,0,0,18,0,-18
4883,1,0,53,0,-53
4884,0,0,168,0,-168
4885,1,0,7,0,-7
4886,0,0,33,0,-33
4887,0,0,19,0,-19
4888,0,0,71,0,-71
4889,0,0,1,0,-1
4890,1,0,3,0,-3
4891,1,1,770,1268,498
4892,0,0,11,0,-11
4893,1,1,779,1212,433
4894,0,0,49,0,-49
4895,1,1,1584,1249,-335
4896,0,0,44,0,-44
4897,0,0,69,0,-69
4898,0,0,138,0,-138
4899,1,1,72,1362,1290
4900,0,0,84,0,-84
4901,0,0,120,0,-120
4902,1,1,435,1664,1229
4903,0,0,5,0,-5
4904,1,0,19,0,-19
4905,1,1,401,1251,850
4906,1,0,27,0,-27
4907,0,0,5,0,-5
4908,0,0,19,0,-19
4909,0,0,69,0,-69
4910,1,0,49,0,-49
4911,1,0,15,0,-15
4912,1,1,559,1386,827
4913,0,0,62,0,-62
4914,1,1,1818,1919,101
4915,0,0,76,0,-76
4916,1,1,255,1321,1066
4917,0,0,17,0,-17
4918,1,1,257,1353,1096
4919,1,1,237,2118,1881
4920,0,0,3,0,-3
4921,0,0,163,0,-163
4922,0,0,25,0,-25
4923,0,0,24,0,-24
4924,0,0,8,0,-8
4925,1,1,435,1521,1086
4926,1,0,62,0,-62
4927,1,1,88,1382,1294
4928,1,0,14,0,-14
4929,1,1,366,1750,1384
4930,0,0,3,0,-3
4931,0,0,19,0,-19
4932,1,0,75,0,-75
4933,0,0,4,0,-4
4934,1,0,101,0,-101
4935,0,0,14,0,-14
4936,1,1,450,1355,905
4937,1,1,690,1386,696
4938,0,0,73,0,-73
4939,1,0,6,0,-6
4940,1,1,129,1250,1121
4941,1,0,291,0,-291
4942,0,0,15,0,-15
4943,0,0,30,0,-30
4944,1,1,128,1876,1748
4945,1,0,5,0,-5
4946,1,0,125,0,-125
4947,1,1,915,1205,290
4948,0,0,42,0,-42
4949,0,0,84,0,-84
4950,0,0,24,0,-24
4951,0,0,7,0,-7
4952,1,0,50,0,-50
4953,0,0,2,0,-2
4954,1,0,19,0,-19
4955,1,0,27,0,-27
4956,1,0,31,0,-31
4957,1,1,421,1309,888
4958,1,0,20,0,-20
4959,0,0,40,0,-40
4960,1,1,332,1213,881
4961,0,0,8,0,-8
4962,0,0,59,0,-59
4963,0,0,37,0,-37
4964,0,0,16,0,-16
4965,1,0,9,0,-9
4966,1,0,112,0,-112
4967,1,1,454,1364,910
4968,1,1,569,1402,833
4969,0,0,21,0,-21
4970,1,0,84,0,-84
4971,0,0,96,0,-96
4972,1,0,48,0,-48
4973,0,0,38,0,-38
4974,0,0,121,0,-121
4975,0,0,63,0,-63
4976,1,1,1104,1277,173
4977,1,0,138,0,-138
4978,1,1,868,1640,772
4979,1,1,370,1388,1018
4980,1,0,32,0,-32
4981,1,0,71,0,-71
4982,1,0,39,0,-39
4983,1,0,42,0,-42
4984,0,0,33,0,-33
4985,1,1,809,1401,592
4986,1,1,191,1875,1684
4987,1,0,12,0,-12
4988,1,0,25,0,-25
4989,0,0,23,0,-23
4990,1,1,555,2052,1497
4991,1,0,111,0,-111
4992,1,1,535,1208,673
4993,1,1,1021,2967,1946
4994,1,1,106,1573,1467
4995,0,0,122,0,-122
4996,1,1,87,1492,1405
4997,0,0,44,0,-44
4998,0,0,16,0,-16
4999,1,0,15,0,-15
5000,0,0,43,0,-43
5001,1,0,1,0,-1
5002,1,1,2630,1568,-1062
5003,1,0,12,0,-12
5004,1,1,1156,1798,642
5005,0,0,28,0,-28
5006,1,0,55,0,-55
5007,1,1,131,1759,1628
5008,0,0,23,0,-23
5009,1,1,599,2488,1889
5010,1,0,42,0,-42
5011,1,0,2,0,-2
5012,1,0,42,0,-42
5013,0,0,41,0,-41
5014,0,0,7,0,-7
5015,0,0,106,0,-106
5016,1,0,38,0,-38
5017,0,0,75,0,-75
5018,0,0,5,0,-5
5019,1,1,972,1590,618
5020,0,0,4,0,-4
5021,0,0,15,0,-15
5022,1,1,313,1242,929
5023,0,0,126,0,-126
5024,1,0,54,0,-54
5025,1,0,111,0,-111
5026,0,0,36,0,-36
5027,0,0,42,0,-42
5028,0,0,125,0,-125
5029,1,0,4,0,-4
5030,1,0,65,0,-65
5031,1,1,200,1790,1590
5032,0,0,6,0,-6
5033,0,0,180,0,-180
5034,1,1,172,1549,1377
5035,1,1,128,1392,1264
5036,1,1,592,2129,1537
5037,0,0,49,0,-49
5038,1,1,60,2022,1962
5039,1,0,43,0,-43
5040,1,0,25,0,-25
5041,0,0,108,0,-108
5042,1,1,57,1775,1718
5043,0,0,28,0,-28
5044,1,0,123,0,-123
5045,1,0,2,0,-2
5046,1,1,49,1693,1644
5047,1,1,320,1228,908
5048,1,0,19,0,-19
5049,1,1,363,1611,1248
5050,0,0,40,0,-40
5051,0,0,5,0,-5
5052,0,0,83,0,-83
5053,1,0,184,0,-184
5054,1,0,6,0,-6
5055,1,1,133,1476,1343
5056,1,1,287,1240,953
5057,1,1,84,3273,3189
5058,0,0,67,0,-67
5059,1,1,316,1781,1465
5060,1,1,336,1226,890
5061,0,0,42,0,-42
5062,1,0,2,0,-2
5063,1,1,27,1622,1595
5064,1,1,398,1295,897
5065,0,0,48,0,-48
5066,0,0,0,0,0
5067,0,0,5,0,-5
5068,1,1,725,1221,496
5069,0,0,82,0,-82
5070,0,0,10,0,-10
5071,1,1,422,1524,1102
5072,1,1,83,1212,1129
5073,1,1,402,1363,961
5074,0,0,1,0,-1
5075,1,1,88,1209,1121
5076,1,1,868,2196,1328
5077,1,0,3,0,-3
5078,0,0,1,0,-1
5079,0,0,7,0,-7
5080,1,1,440,2445,2005
5081,1,0,23,0,-23
5082,1,0,57,0,-57
5083,1,1,315,1431,1116
5084,1,1,405,5264,4859
5085,1,1,114,2229,2115
5086,0,0,74,0,-74
5087,1,0,38,0,-38
5088,0,0,84,0,-84
5089,1,0,4,0,-4
5090,0,0,19,0,-19
5091,1,1,124,1607,1483
5092,1,0,68,0,-68
5093,1,0,5,0,-5
5094,1,0,16,0,-16
5095,0,0,40,0,-40
5096,1,1,1544,1700,156
5097,0,0,50,0,-50
5098,1,0,14,0,-14
5099,0,0,113,0,-113
5100,0,0,129,0,-129
5101,0,0,37,0,-37
5102,1,1,249,1416,1167
5103,1,0,119,0,-119
5104,0,0,42,0,-42
5105,0,0,37,0,-37
5106,0,0,5,0,-5
5107,0,0,52,0,-52
5108,0,0,59,0,-59
5109,1,1,126,1212,1086
5110,0,0,160,0,-160
5111,0,0,102,0,-102
5112,1,0,278,0,-278
5113,0,0,29,0,-29
5114,1,0,26,0,-26
5115,0,0,57,0,-57
5116,1,1,592,1355,763
5117,0,0,69,0,-69
5118,0,0,5,0,-5
5119,0,0,32,0,-32
5120,1,1,1152,1626,474
5121,1,0,7,0,-7
5122,1,1,102,1251,1149
5123,0,0,34,0,-34
5124,1,1,141,1278,1137
5125,0,0,27,0,-27
5126,1,0,18,0,-18
5127,1,0,88,0,-88
5128,1,0,40,0,-40
5129,1,0,99,0,-99
5130,1,0,104,0,-104
5131,1,1,940,1387,447
5132,0,0,37,0,-37
5133,0,0,48,0,-48
5134,0,0,46,0,-46
5135,1,0,99,0,-99
5136,1,1,764,2218,1454
5137,0,0,25,0,-25
5138,1,1,424,1244,820
5139,0,0,75,0,-75
5140,0,0,25,0,-25
5141,0,0,9,0,-9
5142,1,0,5,0,-5
5143,1,0,59,0,-59
5144,0,0,53,0,-53
5145,1,0,23,0,-23
5146,0,0,56,0,-56
5147,1,0,148,0,-148
5148,0,0,134,0,-134
5149,1,1,116,1651,1535
5150,0,0,120,0,-120
5151,1,1,228,3052,2824
5152,1,1,430,1362,932
5153,1,1,351,1372,1021
5154,1,0,16,0,-16
5155,1,0,0,0,0
5156,0,0,6,0,-6
5157,0,0,87,0,-87
5158,0,0,42,0,-42
5159,1,1,1329,1233,-96
5160,1,0,71,0,-71
5161,0,0,0,0,0
5162,0,0,46,0,-46
5163,0,0,115,0,-115
5164,0,0,54,0,-54
5165,0,0,11,0,-11
5166,1,1,62,1657,1595
5167,0,0,92,0,-92
5168,1,0,33,0,-33
5169,1,0,6,0,-6
5170,1,0,40,0,-40
5171,1,1,536,1448,912
5172,0,0,38,0,-38
5173,0,0,95,0,-95
5174,1,0,20,0,-20
5175,1,1,427,2074,1647
5176,1,1,729,1830,1101
5177,1,0,6,0,-6
5178,1,0,378,0,-378
5179,1,0,18,0,-18
5180,1,1,85,1413,1328
5181,1,0,18,0,-18
5182,1,1,928,1393,465
5183,0,0,26,0,-26
5184,0,0,2,0,-2
5185,1,1,51,1304,1253
5186,1,0,5,0,-5
5187,1,1,48,1751,1703
5188,1,0,140,0,-140
5189,1,0,47,0,-47
5190,0,0,86,0,-86
5191,1,1,1221,1260,39
5192,0,0,10,0,-10
5193,0,0,63,0,-63
5194,1,0,126,0,-126
5195,0,0,30,0,-30
5196,1,1,112,1604,1492
5197,0,0,65,0,-65
5198,0,0,1,0,-1
5199,1,1,759,1564,805
5200,1,1,113,1422,1309
5201,1,0,2,0,-2
5202,1,0,53,0,-53
5203,1,0,101,0,-101
5204,1,1,664,1534,870
5205,0,0,33,0,-33
5206,0,0,104,0,-104
5207,0,0,52,0,-52
5208,1,0,50,0,-50
5209,0,0,155,0,-155
5210,1,0,67,0,-67
5211,1,1,246,1257,1011
5212,0,0,58,0,-58
5213,0,0,25,0,-25
5214,1,0,11,0,-11
5215,0,0,36,0,-36
5216,1,1,556,1283,727
5217,0,0,57,0,-57
5218,1,0,8,0,-8
5219,0,0,7,0,-7
5220,0,0,12,0,-12
5221,0,0,120,0,-120
5222,1,1,574,1253,679
5223,0,0,45,0,-45
5224,1,1,631,2239,1608
5225,1,0,105,0,-105
5226,1,0,76,0,-76
5227,1,0,96,0,-96
5228,1,0,70,0,-70
5229,1,1,662,2253,1591
5230,1,1,1107,1360,253
5231,0,0,130,0,-130
5232,1,1,474,1404,930
5233,1,1,547,1228,681
5234,1,1,106,1420,1314
5235,1,1,223,1959,1736
5236,1,0,62,0,-62
5237,0,0,9,0,-9
5238,0,0,82,0,-82
5239,0,0,179,0,-179
5240,1,0,59,0,-59
5241,1,0,3,0,-3
5242,1,0,58,0,-58
5243,1,0,55,0,-55
5244,0,0,92,0,-92
5245,0,0,95,0,-95
5246,0,0,110,0,-110
5247,0,0,44,0,-44
5248,0,0,16,0,-16
5249,1,0,4,0,-4
5250,1,0,23,0,-23
5251,0,0,70,0,-70
5252,1,0,30,0,-30
5253,1,0,61,0,-61
5254,1,1,250,2456,2206
5255,1,0,25,0,-25
5256,1,1,191,1314,1123
5257,1,0,315,0,-315
5258,0,0,54,0,-54
5259,1,0,38,0,-38
5260,1,0,65,0,-65
5261,1,0,43,0,-43
5262,0,0,40,0,-40
5263,1,1,1000,1238,238
5264,0,0,48,0,-48
5265,1,0,28,0,-28
5266,0,0,98,0,-98
5267,1,1,519,1263,744
5268,0,0,133,0,-133
5269,1,0,33,0,-33
5270,1,1,182,1666,1484
5271,1,0,29,0,-29
5272,1,1,505,1239,734
5273,1,0,12,0,-12
5274,1,1,582,2581,1999
5275,0,0,5,0,-5
5276,1,1,332,1323,991
5277,1,1,108,1211,1103
5278,1,1,161,1978,1817
5279,1,0,18,0,-18
5280,0,0,45,0,-45
5281,0,0,4,0,-4
5282,0,0,38,0,-38
5283,1,0,57,0,-57
5284,1,0,29,0,-29
5285,1,1,255,2854,2599
5286,1,1,138,1458,1320
5287,1,0,70,0,-70
5288,1,0,231,0,-231
5289,0,0,29,0,-29
5290,1,0,3,0,-3
5291,1,1,194,2026,1832
5292,1,1,750,1583,833
5293,1,0,28,0,-28
5294,0,0,14,0,-14
5295,1,0,11,0,-11
5296,0,0,45,0,-45
5297,0,0,14,0,-14
5298,0,0,35,0,-35
5299,0,0,56,0,-56
5300,1,1,125,1201,1076
5301,0,0,23,0,-23
5302,0,0,24,0,-24
5303,1,0,96,0,-96
5304,1,1,134,1459,1325
5305,1,0,28,0,-28
5306,0,0,33,0,-33
5307,1,0,208,0,-208
5308,1,0,70,0,-70
5309,0,0,20,0,-20
5310,0,0,61,0,-61
5311,1,1,91,1463,1372
5312,1,1,1833,1474,-359
5313,0,0,27,0,-27
5314,1,1,467,1657,1190
5315,1,0,10,0,-10
5316,1,1,363,1329,966
5317,1,0,3,0,-3
5318,1,1,877,1248,371
5319,0,0,176,0,-176
5320,1,0,89,0,-89
5321,1,1,837,1656,819
5322,1,0,123,0,-123
5323,0,0,24,0,-24
5324,1,1,62,1485,1423
5325,1,0,27,0,-27
5326,1,0,68,0,-68
5327,1,1,283,1399,1116
5328,0,0,7,0,-7
5329,1,0,32,0,-32
5330,0,0,42,0,-42
5331,0,0,37,0,-37
5332,0,0,36,0,-36
5333,1,1,227,1734,1507
5334,0,0,13,0,-13
5335,0,0,46,0,-46
5336,0,0,63,0,-63
5337,1,1,387,1257,870
5338,1,1,438,1431,993
5339,1,0,0,0,0
5340,0,0,34,0,-34
5341,0,0,121,0,-121
5342,1,0,80,0,-80
5343,1,0,85,0,-85
5344,0,0,53,0,-53
5345,0,0,1,0,-1
5346,0,0,21,0,-21
5347,0,0,17,0,-17
5348,0,0,0,0,0
5349,1,1,1124,1237,113
5350,1,0,35,0,-35
5351,0,0,30,0,-30
5352,1,0,12,0,-12
5353,1,1,1578,1221,-357
5354,1,1,561,1478,917
5355,1,0,153,0,-153
5356,1,1,247,1213,966
5357,0,0,24,0,-24
5358,1,0,15,0,-15
5359,0,0,46,0,-46
5360,1,0,5,0,-5
5361,1,0,71,0,-71
5362,1,1,570,1231,661
5363,1,1,96,1503,1407
5364,0,0,36,0,-36
5365,1,0,31,0,-31
5366,1,0,62,0,-62
5367,0,0,264,0,-264
5368,0,0,63,0,-63
5369,1,1,190,1355,1165
5370,1,1,1468,1991,523
5371,1,1,831,1230,399
5372,0,0,41,0,-41
5373,0,0,2,0,-2
5374,1,1,301,1284,983
5375,1,0,14,0,-14
5376,0,0,44,0,-44
5377,1,1,760,1419,659
5378,0,0,90,0,-90
5379,0,0,2,0,-2
5380,0,0,35,0,-35
5381,1,1,637,1391,754
5382,0,0,72,0,-72
5383,0,0,29,0,-29
5384,0,0,13,0,-13
5385,0,0,16,0,-16
5386,0,0,0,0,0
5387,0,0,29,0,-29
5388,0,0,32,0,-32
5389,1,1,519,1358,839
5390,0,0,73,0,-73
5391,1,0,38,0,-38
5392,0,0,5,0,-5
5393,1,1,2256,1222,-1034
5394,1,0,8,0,-8
5395,0,0,10,0,-10
5396,1,0,34,0,-34
5397,0,0,51,0,-51
5398,1,0,60,0,-60
5399,1,1,54,1536,1482
5400,1,0,148,0,-148
5401,1,1,1474,1300,-174
5402,1,0,75,0,-75
5403,1,1,318,1257,939
5404,1,0,120,0,-120
5405,1,1,965,2929,1964
5406,0,0,22,0,-22
5407,1,0,55,0,-55
5408,0,0,86,0,-86
5409,0,0,30,0,-30
5410,0,0,66,0,-66
5411,1,0,152,0,-152
5412,0,0,12,0,-12
5413,1,1,179,3665,3486
5414,0,0,39,0,-39
5415,0,0,25,0,-25
5416,1,1,44,1742,1698
5417,0,0,25,0,-25
5418,0,0,16,0,-16
5419,0,0,31,0,-31
5420,0,0,3,0,-3
5421,1,0,89,0,-89
5422,1,1,1565,1217,-348
5423,0,0,63,0,-63
5424,1,1,297,1239,942
5425,0,0,65,0,-65
5426,1,0,30,0,-30
5427,0,0,5,0,-5
5428,1,1,409,1605,1196
5429,1,0,66,0,-66
5430,1,1,557,1307,750
5431,1,1,771,1938,1167
5432,1,1,315,2033,1718
5433,1,0,9,0,-9
5434,1,0,124,0,-124
5435,1,1,1071,1287,216
5436,1,1,349,1334,985
5437,0,0,258,0,-258
5438,0,0,98,0,-98
5439,0,0,27,0,-27
5440,1,1,230,1592,1362
5441,1,1,88,1234,1146
5442,1,0,22,0,-22
5443,0,0,18,0,-18
5444,1,1,346,1750,1404
5445,0,0,16,0,-16
5446,0,0,0,0,0
5447,0,0,48,0,-48
5448,1,0,0,0,0
5449,1,1,825,1731,906
5450,0,0,218,0,-218
5451,1,1,415,1248,833
5452,0,0,14,0,-14
5453,0,0,29,0,-29
5454,0,0,55,0,-55
5455,1,0,6,0,-6
5456,0,0,16,0,-16
5457,1,1,337,2137,1800
5458,0,0,56,0,-56
5459,0,0,9,0,-9
5460,1,1,590,1722,1132
5461,1,0,32,0,-32
5462,0,0,112,0,-112
5463,0,0,63,0,-63
5464,1,1,872,1373,501
5465,0,0,35,0,-35
5466,1,0,41,0,-41
5467,1,1,410,1291,881
5468,0,0,99,0,-99
5469,0,0,137,0,-137
5470,1,0,34,0,-34
5471,0,0,39,0,-39
5472,0,0,52,0,-52
5473,1,1,949,1344,395
5474,1,1,675,1688,1013
5475,1,1,709,1668,959
5476,1,0,67,0,-67
5477,1,0,71,0,-71
5478,1,0,15,0,-15
5479,1,0,0,0,0
5480,1,1,52,1498,1446
5481,1,0,11,0,-11
5482,0,0,29,0,-29
5483,1,1,171,1479,1308
5484,0,0,0,0,0
5485,1,0,38,0,-38
5486,1,1,146,1401,1255
5487,1,1,328,2913,2585
5488,1,1,179,1322,1143
5489,0,0,6,0,-6
5490,1,1,987,1626,639
5491,1,0,11,0,-11
5492,1,0,44,0,-44
5493,1,1,622,1266,644
5494,1,1,206,1316,1110
5495,1,0,2,0,-2
5496,1,0,109,0,-109
5497,0,0,57,0,-57
5498,0,0,72,0,-72
5499,0,0,7,0,-7
5500,1,1,1449,1486,37
5501,0,0,4,0,-4
5502,1,1,108,1440,1332
5503,0,0,1,0,-1
5504,1,1,1172,1557,385
5505,1,0,166,0,-166
5506,0,0,93,0,-93
5507,0,0,74,0,-74
5508,1,0,34,0,-34
5509,1,0,1,0,-1
5510,1,0,93,0,-93
5511,1,0,24,0,-24
5512,0,0,26,0,-26
5513,1,0,17,0,-17
5514,0,0,133,0,-133
5515,0,0,13,0,-13
5516,1,1,669,1335,666
5517,0,0,72,0,-72
5518,1,0,77,0,-77
5519,0,0,7,0,-7
5520,0,0,57,0,-57
5521,1,1,425,1240,815
5522,1,0,66,0,-66
5523,0,0,23,0,-23
5524,0,0,172,0,-172
5525,1,1,1258,1301,43
5526,1,1,553,1244,691
5527,1,0,25,0,-25
5528,0,0,36,0,-36
5529,1,0,86,0,-86
5530,0,0,35,0,-35
5531,1,1,102,3786,3684
5532,1,0,19,0,-19
5533,1,1,1765,1591,-174
5534,1,1,44,1210,1166
5535,0,0,52,0,-52
5536,1,1,1354,1848,494
5537,0,0,121,0,-121
5538,0,0,32,0,-32
5539,0,0,32,0,-32
5540,1,1,612,1364,752
5541,1,0,13,0,-13
5542,0,0,115,0,-115
5543,0,0,25,0,-25
5544,1,0,40,0,-40
5545,1,0,36,0,-36
5546,1,1,2354,1274,-1080
5547,1,0,36,0,-36
5548,0,0,157,0,-157
5549,1,1,770,3243,2473
5550,1,1,192,1444,1252
5551,1,1,322,2067,1745
5552,1,1,35,1656,1621
5553,0,0,19,0,-19
5554,0,0,15,0,-15
5555,0,0,36,0,-36
5556,0,0,2,0,-2
5557,0,0,16,0,-16
5558,1,0,34,0,-34
5559,1,0,60,0,-60
5560,1,1,454,1232,778
5561,0,0,70,0,-70
5562,0,0,38,0,-38
5563,1,0,29,0,-29
5564,1,1,504,1381,877
5565,0,0,8,0,-8
5566,0,0,58,0,-58
5567,1,1,357,2238,1881
5568,0,0,21,0,-21
5569,1,1,119,1254,1135
5570,0,0,3,0,-3
5571,1,0,4,0,-4
5572,1,0,87,0,-87
5573,1,1,244,1209,965
5574,1,1,419,2315,1896
5575,1,0,27,0,-27
5576,1,1,1018,1442,424
5577,1,0,37,0,-37
5578,1,0,58,0,-58
5579,1,0,8,0,-8
5580,0,0,7,0,-7
5581,0,0,39,0,-39
5582,1,1,167,1364,1197
5583,1,0,23,0,-23
5584,1,1,239,1358,1119
5585,0,0,0,0,0
5586,0,0,39,0,-39
5587,0,0,75,0,-75
5588,1,0,55,0,-55
5589,1,1,430,1856,1426
5590,0,0,30,0,-30
5591,0,0,182,0,-182
5592,1,0,4,0,-4
5593,1,1,439,3145,2706
5594,1,0,39,0,-39
5595,1,0,80,0,-80
5596,1,1,610,1368,758
5597,1,0,51,0,-51
5598,1,0,9,0,-9
5599,1,1,324,1269,945
5600,0,0,10,0,-10
5601,1,1,203,1550,1347
5602,1,0,40,0,-40
5603,0,0,108,0,-108
5604,0,0,58,0,-58
5605,1,1,417,1228,811
5606,1,1,1748,1498,-250
5607,1,1,620,1298,678
5608,0,0,44,0,-44
5609,0,0,63,0,-63
5610,0,0,138,0,-138
5611,0,0,93,0,-93
5612,0,0,0,0,0
5613,1,0,20,0,-20
5614,1,0,37,0,-37
5615,0,0,7,0,-7
5616,1,0,36,0,-36
5617,1,1,389,1207,818
5618,0,0,85,0,-85
5619,0,0,77,0,-77
5620,1,1,458,1329,871
5621,1,1,417,1333,916
5622,1,0,64,0,-64
5623,1,0,4,0,-4
5624,0,0,62,0,-62
5625,1,0,7,0,-7
5626,0,0,29,0,-29
5627,1,0,109,0,-109
5628,0,0,97,0,-97
5629,1,0,53,0,-53
5630,1,1,70,1288,1218
5631,1,1,863,1310,447
5632,1,1,321,1650,1329
5633,1,0,35,0,-35
5634,1,0,26,0,-26
5635,1,1,240,1626,1386
5636,0,0,50,0,-50
5637,0,0,20,0,-20
5638,0,0,7,0,-7
5639,0,0,12,0,-12
5640,0,0,41,0,-41
5641,0,0,50,0,-50
5642,0,0,2,0,-2
5643,0,0,6,0,-6
5644,1,0,68,0,-68
5645,1,1,814,1366,552
5646,1,0,103,0,-103
5647,0,0,44,0,-44
5648,1,0,21,0,-21
5649,1,1,252,1266,1014
5650,0,0,3,0,-3
5651,0,0,53,0,-53
5652,1,1,562,2401,1839
5653,0,0,20,0,-20
5654,1,1,105,1344,1239
5655,1,1,270,1329,1059
5656,1,1,127,1217,1090
5657,1,0,38,0,-38
5658,0,0,29,0,-29
5659,1,0,11,0,-11
5660,1,1,445,1539,1094
5661,1,0,41,0,-41
5662,1,0,80,0,-80
5663,0,0,41,0,-41
5664,1,1,619,1416,797
5665,0,0,44,0,-44
5666,0,0,30,0,-30
5667,0,0,64,0,-64
5668,0,0,24,0,-24
5669,1,0,0,0,0
5670,0,0,84,0,-84
5671,0,0,224,0,-224
5672,0,0,10,0,-10
5673,1,1,711,1265,554
5674,1,0,164,0,-164
5675,1,0,50,0,-50
5676,1,1,657,1212,555
5677,1,1,683,1234,551
5678,0,0,21,0,-21
5679,1,0,134,0,-134
5680,1,0,37,0,-37
5681,0,0,42,0,-42
5682,0,0,84,0,-84
5683,0,0,149,0,-149
5684,1,0,2,0,-2
5685,0,0,166,0,-166
5686,0,0,37,0,-37
5687,0,0,8,0,-8
5688,0,0,10,0,-10
5689,0,0,129,0,-129
5690,1,0,127,0,-127
5691,1,0,26,0,-26
5692,0,0,20,0,-20
5693,0,0,12,0,-12
5694,1,0,15,0,-15
5695,0,0,26,0,-26
5696,1,0,13,0,-13
5697,1,0,42,0,-42
5698,1,0,31,0,-31
5699,0,0,86,0,-86
5700,1,0,24,0,-24
5701,0,0,1,0,-1
5702,1,0,26,0,-26
5703,1,0,0,0,0
5704,0,0,13,0,-13
5705,1,1,233,1658,1425
5706,0,0,69,0,-69
5707,1,0,35,0,-35
5708,0,0,48,0,-48
5709,0,0,18,0,-18
5710,0,0,23,0,-23
5711,0,0,12,0,-12
5712,0,0,2,0,-2
5713,0,0,55,0,-55
5714,0,0,11,0,-11
5715,1,1,431,1366,935
5716,1,1,735,1603,868
5717,1,1,171,1734,1563
5718,0,0,38,0,-38
5719,0,0,36,0,-36
5720,1,1,1202,1780,578
5721,0,0,13,0,-13
5722,0,0,79,0,-79
5723,0,0,74,0,-74
5724,0,0,17,0,-17
5725,0,0,13,0,-13
5726,0,0,18,0,-18
5727,0,0,26,0,-26
5728,0,0,60,0,-60
5729,1,1,2392,1311,-1081
5730,0,0,9,0,-9
5731,1,1,948,2760,1812
5732,0,0,45,0,-45
5733,0,0,11,0,-11
5734,1,0,57,0,-57
5735,0,0,29,0,-29
5736,1,1,195,2113,1918
5737,0,0,8,0,-8
5738,1,1,323,1267,944
5739,0,0,17,0,-17
5740,1,1,1219,2007,788
5741,1,0,16,0,-16
5742,1,1,883,1322,439
5743,0,0,92,0,-92
5744,1,0,16,0,-16
5745,1,1,51,1312,1261
5746,0,0,9,0,-9
5747,0,0,38,0,-38
5748,0,0,34,0,-34
5749,0,0,115,0,-115
5750,1,1,1033,1299,266
5751,1,1,132,2151,2019
5752,1,0,15,0,-15
5753,1,0,48,0,-48
5754,1,1,377,1574,1197
5755,1,0,46,0,-46
5756,1,0,15,0,-15
5757,1,0,141,0,-141
5758,1,0,56,0,-56
5759,1,0,10,0,-10
5760,1,0,59,0,-59
5761,1,0,51,0,-51
5762,0,0,40,0,-40
5763,1,0,28,0,-28
5764,1,1,196,1211,1015
5765,0,0,64,0,-64
5766,0,0,0,0,0
5767,0,0,29,0,-29
5768,0,0,6,0,-6
5769,1,0,3,0,-3
5770,0,0,6,0,-6
5771,1,1,1253,1348,95
5772,0,0,45,0,-45
5773,1,0,51,0,-51
5774,1,1,1246,1209,-37
5775,0,0,47,0,-47
5776,1,1,497,1295,798
5777,1,1,218,1395,1177
5778,1,1,189,1242,1053
